ID	Type	Value	Estimate	Difference	PercentDifference	Confidence	ResponseTime
p01	bars	61	39	22	0.36065573	medium	35672
p01	bars	84	88	4	0.04761905	medium	13438
p01	bars	63	65	2	0.031746034	medium	6640
p01	bars	72	68	4	0.055555556	medium	15953
p01	bars	91	93	2	0.021978023	medium	7000
p01	bars	50	50	0	0.0	high	7360
p01	bars	46	46	0	0.0	medium	9531
p01	bars	80	80	0	0.0	medium	12609
p01	bars	66	67	1	0.015151516	medium	14250
p01	bars	89	90	1	0.011235955	medium	8907
p01	bars	74	80	6	0.08108108	medium	10562
p01	bars	17	15	2	0.11764706	medium	6953
p01	bars	75	69	6	0.08	medium	10594
p01	bars	61	56	5	0.08196721	medium	6609
p01	bars	26	25	1	0.03846154	medium	10859
p01	bars	90	93	3	0.033333335	medium	7579
p01	bars	61	60	1	0.016393442	medium	18937
p01	bars	34	33	1	0.029411765	medium	6109
p01	bars	43	41	2	0.046511628	medium	14938
p01	bars	50	48	2	0.04	medium	7703
p01	piechart	57	56	1	0.01754386	medium	13953
p01	piechart	47	48	1	0.021276595	medium	7438
p01	piechart	33	38	5	0.15151516	medium	10265
p01	piechart	31	37	6	0.19354838	medium	4125
p01	piechart	37	39	2	0.054054055	medium	7110
p01	piechart	72	71	1	0.013888889	medium	8875
p01	piechart	38	39	1	0.02631579	medium	12015
p01	piechart	41	40	1	0.024390243	medium	5172
p01	piechart	1	1	0	0.0	medium	7735
p01	piechart	57	55	2	0.03508772	medium	10640
p01	piechart	64	60	4	0.0625	medium	6875
p01	piechart	38	37	1	0.02631579	medium	6641
p01	piechart	52	52	0	0.0	medium	5109
p01	piechart	59	60	1	0.016949153	medium	9594
p01	piechart	62	63	1	0.016129032	medium	4938
p01	piechart	80	78	2	0.025	medium	11093
p01	piechart	90	84	6	0.06666667	medium	10250
p01	piechart	69	71	2	0.028985508	medium	8407
p01	piechart	74	74	0	0.0	medium	4093
p01	piechart	99	98	1	0.01010101	medium	6500
p01	donut	58	63	5	0.0862069	medium	9437
p01	donut	67	71	4	0.05970149	medium	16157
p01	donut	1	1	0	0.0	high	4546
p01	donut	36	33	3	0.083333336	medium	16219
p01	donut	70	67	3	0.042857144	medium	4609
p01	donut	1	1	0	0.0	high	5297
p01	donut	8	10	2	0.25	medium	7000
p01	donut	27	26	1	0.037037037	medium	3953
p01	donut	11	12	1	0.09090909	medium	5766
p01	donut	32	29	3	0.09375	medium	10437
p01	donut	52	51	1	0.01923077	high	6610
p01	donut	99	99	0	0.0	high	5922
p01	donut	81	80	1	0.012345679	medium	4781
p01	donut	28	28	0	0.0	medium	5640
p01	donut	21	20	1	0.04761905	medium	6313
p01	donut	24	24	0	0.0	high	4812
p01	donut	32	27	5	0.15625	medium	6157
p01	donut	39	36	3	0.07692308	medium	17890
p01	donut	8	7	1	0.125	medium	10125
p01	donut	44	42	2	0.045454547	medium	8766
p01	squarepie	57	57	0	0.0	high	19187
p01	squarepie	33	33	0	0.0	high	22016
p01	squarepie	37	37	0	0.0	high	6672
p01	squarepie	22	22	0	0.0	high	6343
p01	squarepie	68	68	0	0.0	high	9094
p01	squarepie	66	67	1	0.015151516	high	8953
p01	squarepie	49	49	0	0.0	high	8891
p01	squarepie	32	32	0	0.0	high	6031
p01	squarepie	70	70	0	0.0	medium	10766
p01	squarepie	61	61	0	0.0	high	6156
p01	squarepie	35	35	0	0.0	high	5641
p01	squarepie	77	77	0	0.0	high	10531
p01	squarepie	57	57	0	0.0	high	10328
p01	squarepie	48	48	0	0.0	high	6953
p01	squarepie	27	27	0	0.0	high	12828
p01	squarepie	33	33	0	0.0	high	7032
p01	squarepie	99	99	0	0.0	high	4265
p01	squarepie	90	90	0	0.0	high	3453
p01	squarepie	44	44	0	0.0	high	7203
p01	squarepie	40	40	0	0.0	high	6329
p02	bars	87	90	3	0.03448276	high	57533
p02	bars	8	8	0	0.0	medium	13071
p02	bars	78	79	1	0.012820513	medium	10094
p02	bars	52	52	0	0.0	medium	9774
p02	bars	44	41	3	0.06818182	medium	8886
p02	bars	37	36	1	0.027027028	medium	5660
p02	bars	95	95	0	0.0	high	5053
p02	bars	59	59	0	0.0	medium	12777
p02	bars	30	30	0	0.0	medium	5313
p02	bars	22	20	2	0.09090909	medium	11046
p02	bars	63	66	3	0.04761905	medium	6729
p02	bars	52	50	2	0.03846154	high	6154
p02	bars	22	22	0	0.0	medium	6673
p02	bars	26	25	1	0.03846154	medium	5028
p02	bars	45	44	1	0.022222223	medium	4589
p02	bars	70	70	0	0.0	medium	6111
p02	bars	33	33	0	0.0	medium	3376
p02	bars	90	92	2	0.022222223	medium	6402
p02	bars	46	50	4	0.08695652	high	2989
p02	bars	71	66	5	0.07042254	high	4253
p02	piechart	99	99	0	0.0	high	10787
p02	piechart	61	66	5	0.08196721	high	6854
p02	piechart	43	40	3	0.069767445	medium	7502
p02	piechart	74	72	2	0.027027028	high	5113
p02	piechart	99	99	0	0.0	high	10169
p02	piechart	49	48	1	0.020408163	high	3902
p02	piechart	55	55	0	0.0	high	5256
p02	piechart	22	20	2	0.09090909	high	5436
p02	piechart	19	15	4	0.21052632	medium	3755
p02	piechart	76	77	1	0.013157895	high	7156
p02	piechart	60	66	6	0.1	high	2904
p02	piechart	1	2	1	1.0	high	9123
p02	piechart	62	65	3	0.048387095	high	6845
p02	piechart	56	57	1	0.017857144	medium	5205
p02	piechart	97	95	2	0.020618556	high	4069
p02	piechart	47	45	2	0.04255319	high	3242
p02	piechart	36	33	3	0.083333336	high	3031
p02	piechart	39	40	1	0.025641026	medium	4620
p02	piechart	34	33	1	0.029411765	high	2766
p02	piechart	79	80	1	0.012658228	high	4692
p02	donut	79	80	1	0.012658228	high	5742
p02	donut	48	43	5	0.104166664	high	9180
p02	donut	3	5	2	0.6666667	high	3265
p02	donut	37	33	4	0.10810811	high	2195
p02	donut	46	45	1	0.02173913	medium	3363
p02	donut	12	13	1	0.083333336	high	7575
p02	donut	58	60	2	0.03448276	medium	9103
p02	donut	43	40	3	0.069767445	medium	5314
p02	donut	24	25	1	0.041666668	high	2957
p02	donut	32	35	3	0.09375	high	4487
p02	donut	20	18	2	0.1	medium	5115
p02	donut	71	70	1	0.014084507	high	6453
p02	donut	33	35	2	0.060606062	medium	6745
p02	donut	99	99	0	0.0	high	2796
p02	donut	1	1	0	0.0	high	3989
p02	donut	36	35	1	0.027777778	medium	3778
p02	donut	46	45	1	0.02173913	high	3554
p02	donut	1	1	0	0.0	high	10582
p02	donut	90	90	0	0.0	medium	8476
p02	donut	33	34	1	0.030303031	medium	5350
p02	squarepie	56	50	6	0.10714286	medium	13909
p02	squarepie	65	65	0	0.0	low	7869
p02	squarepie	92	92	0	0.0	high	13142
p02	squarepie	43	33	10	0.23255815	medium	13859
p02	squarepie	47	37	10	0.21276596	medium	9472
p02	squarepie	55	55	0	0.0	high	20648
p02	squarepie	52	52	0	0.0	high	4373
p02	squarepie	42	32	10	0.23809524	medium	14678
p02	squarepie	63	63	0	0.0	medium	13294
p02	squarepie	91	91	0	0.0	high	10335
p02	squarepie	2	2	0	0.0	high	6110
p02	squarepie	99	99	0	0.0	high	6738
p02	squarepie	1	1	0	0.0	high	2745
p02	squarepie	37	37	0	0.0	high	16357
p02	squarepie	44	44	0	0.0	high	5572
p02	squarepie	26	26	0	0.0	high	9076
p02	squarepie	73	83	10	0.1369863	high	15951
p02	squarepie	86	86	0	0.0	high	16773
p02	squarepie	83	83	0	0.0	high	8534
p02	squarepie	19	19	0	0.0	high	5571
p03	piechart	47	55	8	0.17021276	high	27688
p03	piechart	55	45	10	0.18181819	high	13328
p03	piechart	87	80	7	0.08045977	medium	8984
p03	piechart	90	90	0	0.0	medium	6969
p03	piechart	42	40	2	0.04761905	medium	9219
p03	piechart	29	30	1	0.03448276	high	6937
p03	piechart	71	70	1	0.014084507	high	5203
p03	piechart	30	30	0	0.0	high	8579
p03	piechart	69	65	4	0.057971016	medium	16265
p03	piechart	33	35	2	0.060606062	medium	8687
p03	piechart	72	70	2	0.027777778	high	4266
p03	piechart	51	52	1	0.019607844	high	8000
p03	piechart	22	22	0	0.0	medium	14234
p03	piechart	53	55	2	0.03773585	high	11641
p03	piechart	22	22	0	0.0	medium	8266
p03	piechart	36	35	1	0.027777778	high	11046
p03	piechart	53	53	0	0.0	medium	11719
p03	piechart	17	18	1	0.05882353	medium	12953
p03	piechart	70	70	0	0.0	high	6657
p03	piechart	54	55	1	0.018518519	high	5687
p03	donut	55	55	0	0.0	high	5516
p03	donut	11	10	1	0.09090909	medium	5766
p03	donut	1	2	1	1.0	medium	4953
p03	donut	26	26	0	0.0	high	5797
p03	donut	72	72	0	0.0	medium	4640
p03	donut	88	82	6	0.06818182	medium	12094
p03	donut	73	73	0	0.0	medium	3922
p03	donut	58	58	0	0.0	medium	5297
p03	donut	1	2	1	1.0	medium	4500
p03	donut	99	98	1	0.01010101	high	9937
p03	donut	30	30	0	0.0	medium	4797
p03	donut	12	10	2	0.16666667	medium	6094
p03	donut	60	60	0	0.0	medium	5219
p03	donut	37	35	2	0.054054055	medium	13328
p03	donut	23	22	1	0.04347826	high	8797
p03	donut	55	55	0	0.0	medium	4593
p03	donut	1	2	1	1.0	high	4688
p03	donut	10	10	0	0.0	medium	3422
p03	donut	19	18	1	0.05263158	medium	5468
p03	donut	8	10	2	0.25	medium	10235
p03	bars	30	35	5	0.16666667	medium	9250
p03	bars	38	40	2	0.05263158	medium	8812
p03	bars	59	55	4	0.06779661	medium	25766
p03	bars	65	60	5	0.07692308	medium	4265
p03	bars	39	35	4	0.102564104	medium	17641
p03	bars	27	25	2	0.074074075	high	8812
p03	bars	36	30	6	0.16666667	medium	4219
p03	bars	87	80	7	0.08045977	medium	8734
p03	bars	32	30	2	0.0625	medium	5954
p03	bars	64	60	4	0.0625	medium	8250
p03	bars	87	85	2	0.022988506	medium	7015
p03	bars	82	82	0	0.0	medium	4297
p03	bars	39	40	1	0.025641026	medium	11969
p03	bars	87	85	2	0.022988506	medium	11203
p03	bars	22	20	2	0.09090909	medium	3766
p03	bars	99	98	1	0.01010101	high	4187
p03	bars	58	55	3	0.05172414	medium	4563
p03	bars	71	65	6	0.08450704	medium	3718
p03	bars	20	20	0	0.0	medium	4407
p03	bars	50	50	0	0.0	high	30031
p03	squarepie	10	10	0	0.0	medium	37515
p03	squarepie	79	75	4	0.050632913	medium	4079
p03	squarepie	8	8	0	0.0	medium	16218
p03	squarepie	68	70	2	0.029411765	medium	29641
p03	squarepie	35	33	2	0.057142857	medium	4609
p03	squarepie	68	65	3	0.04411765	medium	8047
p03	squarepie	52	52	0	0.0	medium	7625
p03	squarepie	17	18	1	0.05882353	medium	6781
p03	squarepie	62	61	1	0.016129032	medium	5782
p03	squarepie	16	16	0	0.0	medium	5766
p03	squarepie	43	43	0	0.0	medium	5078
p03	squarepie	97	97	0	0.0	medium	5969
p03	squarepie	38	38	0	0.0	medium	18094
p03	squarepie	98	98	0	0.0	medium	2703
p03	squarepie	64	64	0	0.0	medium	5578
p03	squarepie	43	43	0	0.0	medium	5484
p03	squarepie	23	23	0	0.0	medium	11844
p03	squarepie	20	20	0	0.0	medium	2906
p03	squarepie	9	9	0	0.0	medium	4719
p03	squarepie	69	69	0	0.0	medium	5203
p04	bars	52	45	7	0.13461539	medium	39301
p04	bars	64	60	4	0.0625	medium	8301
p04	bars	55	55	0	0.0	medium	4885
p04	bars	59	60	1	0.016949153	medium	7277
p04	bars	51	50	1	0.019607844	medium	5376
p04	bars	92	90	2	0.02173913	medium	6898
p04	bars	70	75	5	0.071428575	medium	5257
p04	bars	49	50	1	0.020408163	medium	4420
p04	bars	99	99	0	0.0	high	9925
p04	bars	9	10	1	0.11111111	high	23164
p04	bars	51	50	1	0.019607844	medium	3476
p04	bars	53	53	0	0.0	medium	5511
p04	bars	67	70	3	0.04477612	medium	4728
p04	bars	43	40	3	0.069767445	medium	5439
p04	bars	61	60	1	0.016393442	medium	2507
p04	bars	83	80	3	0.036144577	medium	5298
p04	bars	54	55	1	0.018518519	medium	4854
p04	bars	66	70	4	0.060606062	medium	6921
p04	bars	53	55	2	0.03773585	medium	2446
p04	bars	45	40	5	0.11111111	medium	3297
p04	piechart	81	60	21	0.25925925	medium	16885
p04	piechart	69	60	9	0.13043478	medium	15188
p04	piechart	55	55	0	0.0	medium	8997
p04	piechart	50	50	0	0.0	high	3622
p04	piechart	1	1	0	0.0	high	4743
p04	piechart	57	60	3	0.05263158	high	7235
p04	piechart	47	45	2	0.04255319	high	5604
p04	piechart	91	80	11	0.12087912	high	3496
p04	piechart	42	40	2	0.04761905	high	5767
p04	piechart	24	23	1	0.041666668	high	11114
p04	piechart	97	95	2	0.020618556	high	6341
p04	piechart	70	70	0	0.0	medium	6000
p04	piechart	86	80	6	0.069767445	medium	20489
p04	piechart	73	7	66	0.9041096	medium	8843
p04	piechart	52	55	3	0.057692308	medium	8879
p04	piechart	38	40	2	0.05263158	medium	10118
p04	piechart	44	45	1	0.022727273	high	4996
p04	piechart	89	80	9	0.101123594	medium	6682
p04	piechart	48	48	0	0.0	high	8090
p04	piechart	97	95	2	0.020618556	high	5701
p04	squarepie	6	6	0	0.0	high	18707
p04	squarepie	45	45	0	0.0	high	14112
p04	squarepie	67	68	1	0.014925373	high	12398
p04	squarepie	45	45	0	0.0	high	3656
p04	squarepie	67	67	0	0.0	high	8367
p04	squarepie	84	84	0	0.0	high	7788
p04	squarepie	49	49	0	0.0	high	8261
p04	squarepie	36	36	0	0.0	high	10272
p04	squarepie	45	35	10	0.22222222	high	5316
p04	squarepie	32	32	0	0.0	high	6945
p04	squarepie	48	48	0	0.0	high	5512
p04	squarepie	35	35	0	0.0	high	5562
p04	squarepie	37	37	0	0.0	high	4578
p04	squarepie	18	18	0	0.0	high	5910
p04	squarepie	51	51	0	0.0	high	4061
p04	squarepie	36	36	0	0.0	high	4251
p04	squarepie	87	87	0	0.0	high	3737
p04	squarepie	28	28	0	0.0	high	6159
p04	squarepie	85	95	10	0.11764706	high	4247
p04	squarepie	61	61	0	0.0	high	3209
p04	donut	72	70	2	0.027777778	medium	14725
p04	donut	37	40	3	0.08108108	medium	3868
p04	donut	77	79	2	0.025974026	medium	7401
p04	donut	71	72	1	0.014084507	medium	5268
p04	donut	16	15	1	0.0625	medium	7566
p04	donut	56	55	1	0.017857144	medium	6273
p04	donut	36	35	1	0.027777778	medium	4818
p04	donut	46	45	1	0.02173913	medium	4892
p04	donut	82	80	2	0.024390243	medium	10124
p04	donut	76	76	0	0.0	high	8548
p04	donut	46	45	1	0.02173913	medium	8365
p04	donut	63	60	3	0.04761905	medium	8374
p04	donut	59	60	1	0.016949153	medium	7791
p04	donut	48	45	3	0.0625	medium	4295
p04	donut	62	65	3	0.048387095	medium	9609
p04	donut	42	45	3	0.071428575	medium	5914
p04	donut	68	70	2	0.029411765	medium	2272
p04	donut	54	55	1	0.018518519	medium	2325
p04	donut	72	72	0	0.0	medium	4762
p04	donut	74	74	0	0.0	high	6840
p05	bars	45	35	10	0.22222222	medium	63375
p05	bars	35	20	15	0.42857143	medium	12422
p05	bars	41	37	4	0.09756097	medium	8422
p05	bars	24	17	7	0.29166666	high	8718
p05	bars	60	65	5	0.083333336	medium	9157
p05	bars	43	40	3	0.069767445	medium	7218
p05	bars	58	60	2	0.03448276	medium	9188
p05	bars	99	97	2	0.02020202	medium	5500
p05	bars	1	3	2	2.0	medium	8641
p05	bars	50	50	0	0.0	high	5234
p05	bars	73	75	2	0.02739726	medium	6125
p05	bars	69	70	1	0.014492754	medium	7969
p05	bars	16	20	4	0.25	medium	5515
p05	bars	69	70	1	0.014492754	medium	9094
p05	bars	81	75	6	0.074074075	medium	4188
p05	bars	90	87	3	0.033333335	medium	7625
p05	bars	54	55	1	0.018518519	medium	4766
p05	bars	47	45	2	0.04255319	medium	4000
p05	bars	62	65	3	0.048387095	medium	4672
p05	bars	33	45	12	0.36363637	medium	6687
p05	donut	55	55	0	0.0	medium	13797
p05	donut	58	60	2	0.03448276	medium	39016
p05	donut	41	46	5	0.12195122	medium	6906
p05	donut	48	48	0	0.0	medium	6672
p05	donut	41	45	4	0.09756097	medium	6516
p05	donut	54	55	1	0.018518519	medium	7516
p05	donut	60	65	5	0.083333336	medium	6391
p05	donut	70	70	0	0.0	medium	3609
p05	donut	42	43	1	0.023809524	medium	6016
p05	donut	21	20	1	0.04761905	medium	8344
p05	donut	83	82	1	0.012048192	high	16140
p05	donut	15	15	0	0.0	medium	7750
p05	donut	61	58	3	0.04918033	medium	14953
p05	donut	68	66	2	0.029411765	medium	33735
p05	donut	62	60	2	0.032258064	medium	31781
p05	donut	25	25	0	0.0	high	7218
p05	donut	40	37	3	0.075	medium	13266
p05	donut	98	98	0	0.0	high	6625
p05	donut	53	52	1	0.018867925	medium	6062
p05	donut	60	62	2	0.033333335	medium	6844
p05	piechart	70	65	5	0.071428575	medium	17094
p05	piechart	33	35	2	0.060606062	medium	11406
p05	piechart	65	67	2	0.03076923	high	10672
p05	piechart	94	90	4	0.04255319	medium	5766
p05	piechart	65	67	2	0.03076923	medium	12156
p05	piechart	47	47	0	0.0	medium	21688
p05	piechart	27	26	1	0.037037037	medium	13281
p05	piechart	72	72	0	0.0	medium	6797
p05	piechart	9	12	3	0.33333334	medium	6359
p05	piechart	44	45	1	0.022727273	medium	14360
p05	piechart	35	35	0	0.0	medium	5968
p05	piechart	51	51	0	0.0	high	9078
p05	piechart	36	38	2	0.055555556	medium	8954
p05	piechart	55	55	0	0.0	medium	7640
p05	piechart	83	80	3	0.036144577	medium	8297
p05	piechart	27	28	1	0.037037037	medium	6234
p05	piechart	44	45	1	0.022727273	medium	5016
p05	piechart	1	1	0	0.0	high	5922
p05	piechart	46	48	2	0.04347826	medium	7422
p05	piechart	50	50	0	0.0	high	6672
p05	squarepie	9	9	0	0.0	high	28640
p05	squarepie	21	21	0	0.0	high	5938
p05	squarepie	51	41	10	0.19607843	high	13328
p05	squarepie	30	30	0	0.0	high	9969
p05	squarepie	60	60	0	0.0	high	6968
p05	squarepie	37	37	0	0.0	high	8844
p05	squarepie	44	43	1	0.022727273	high	6062
p05	squarepie	59	59	0	0.0	medium	7078
p05	squarepie	1	1	0	0.0	high	3406
p05	squarepie	39	39	0	0.0	high	19328
p05	squarepie	85	95	10	0.11764706	high	10844
p05	squarepie	1	1	0	0.0	high	4859
p05	squarepie	26	26	0	0.0	high	11516
p05	squarepie	36	36	0	0.0	high	7078
p05	squarepie	12	12	0	0.0	high	4906
p05	squarepie	37	27	10	0.27027026	high	9641
p05	squarepie	72	72	0	0.0	high	6062
p05	squarepie	33	33	0	0.0	high	7875
p05	squarepie	63	63	0	0.0	high	9438
p05	squarepie	87	87	0	0.0	high	10031
p06	squarepie	69	78	9	0.13043478	high	29125
p06	squarepie	30	30	0	0.0	high	6234
p06	squarepie	34	34	0	0.0	high	9797
p06	squarepie	32	32	0	0.0	high	4437
p06	squarepie	77	78	1	0.012987013	medium	8485
p06	squarepie	48	48	0	0.0	high	8562
p06	squarepie	55	56	1	0.018181818	high	6766
p06	squarepie	26	36	10	0.3846154	high	8359
p06	squarepie	89	89	0	0.0	high	14500
p06	squarepie	36	36	0	0.0	high	7422
p06	squarepie	54	54	0	0.0	high	3672
p06	squarepie	30	30	0	0.0	high	2453
p06	squarepie	65	76	11	0.16923077	high	7047
p06	squarepie	86	88	2	0.023255814	high	6203
p06	squarepie	69	79	10	0.14492753	high	3469
p06	squarepie	52	52	0	0.0	high	17719
p06	squarepie	22	23	1	0.045454547	medium	5312
p06	squarepie	40	40	0	0.0	high	3704
p06	squarepie	67	68	1	0.014925373	high	4734
p06	squarepie	23	23	0	0.0	high	5797
p06	piechart	83	85	2	0.024096385	medium	9500
p06	piechart	48	48	0	0.0	high	3531
p06	piechart	51	52	1	0.019607844	high	3219
p06	piechart	72	72	0	0.0	medium	8328
p06	piechart	56	60	4	0.071428575	high	2953
p06	piechart	54	55	1	0.018518519	medium	4109
p06	piechart	64	65	1	0.015625	medium	6375
p06	piechart	34	15	19	0.5588235	medium	5297
p06	piechart	38	18	20	0.5263158	medium	5516
p06	piechart	50	50	0	0.0	high	2859
p06	piechart	53	53	0	0.0	high	3735
p06	piechart	98	97	1	0.010204081	high	4515
p06	piechart	35	35	0	0.0	high	11703
p06	piechart	29	30	1	0.03448276	high	2375
p06	piechart	55	60	5	0.09090909	medium	4454
p06	piechart	71	70	1	0.014084507	high	6047
p06	piechart	46	46	0	0.0	high	4828
p06	piechart	51	51	0	0.0	high	5609
p06	piechart	72	74	2	0.027777778	high	5438
p06	piechart	61	70	9	0.14754099	high	2172
p06	bars	18	10	8	0.44444445	high	2890
p06	bars	39	40	1	0.025641026	high	4985
p06	bars	43	38	5	0.11627907	high	5187
p06	bars	50	45	5	0.1	high	3547
p06	bars	27	20	7	0.25925925	high	5641
p06	bars	93	95	2	0.021505376	high	4703
p06	bars	44	35	9	0.20454545	high	7859
p06	bars	90	90	0	0.0	medium	4000
p06	bars	99	98	1	0.01010101	high	3000
p06	bars	57	65	8	0.14035088	medium	4594
p06	bars	81	80	1	0.012345679	medium	7109
p06	bars	83	82	1	0.012048192	medium	1922
p06	bars	48	45	3	0.0625	medium	3375
p06	bars	63	55	8	0.12698413	medium	4875
p06	bars	59	52	7	0.118644066	medium	3172
p06	bars	24	15	9	0.375	medium	2922
p06	bars	42	30	12	0.2857143	medium	5531
p06	bars	69	70	1	0.014492754	medium	4125
p06	bars	34	35	1	0.029411765	medium	2890
p06	bars	92	93	1	0.010869565	high	5266
p06	donut	14	10	4	0.2857143	medium	2891
p06	donut	60	60	0	0.0	medium	5640
p06	donut	30	30	0	0.0	medium	7172
p06	donut	18	15	3	0.16666667	high	2406
p06	donut	72	72	0	0.0	medium	3688
p06	donut	37	20	17	0.45945945	high	3937
p06	donut	60	60	0	0.0	medium	6672
p06	donut	48	48	0	0.0	high	6203
p06	donut	10	5	5	0.5	high	2891
p06	donut	41	45	4	0.09756097	high	4734
p06	donut	9	7	2	0.22222222	high	3719
p06	donut	18	10	8	0.44444445	high	2110
p06	donut	38	45	7	0.18421052	medium	5656
p06	donut	53	52	1	0.018867925	medium	5297
p06	donut	40	45	5	0.125	medium	3484
p06	donut	15	12	3	0.2	medium	7109
p06	donut	50	50	0	0.0	medium	2157
p06	donut	39	45	6	0.15384616	high	4265
p06	donut	35	40	5	0.14285715	high	8719
p06	donut	65	60	5	0.07692308	high	4125
p07	piechart	73	73	0	0.0	high	20668
p07	piechart	1	2	1	1.0	medium	6453
p07	piechart	28	30	2	0.071428575	high	6476
p07	piechart	37	35	2	0.054054055	medium	12348
p07	piechart	19	15	4	0.21052632	medium	4765
p07	piechart	11	10	1	0.09090909	medium	4142
p07	piechart	55	55	0	0.0	medium	3780
p07	piechart	49	48	1	0.020408163	high	3502
p07	piechart	33	30	3	0.09090909	medium	5661
p07	piechart	1	2	1	1.0	medium	2184
p07	piechart	59	60	1	0.016949153	medium	7700
p07	piechart	16	15	1	0.0625	medium	4021
p07	piechart	55	60	5	0.09090909	medium	3158
p07	piechart	62	65	3	0.048387095	medium	4189
p07	piechart	18	15	3	0.16666667	medium	3909
p07	piechart	33	30	3	0.09090909	medium	3437
p07	piechart	70	70	0	0.0	medium	4974
p07	piechart	52	53	1	0.01923077	medium	4061
p07	piechart	58	55	3	0.05172414	medium	2429
p07	piechart	72	70	2	0.027777778	medium	3461
p07	bars	51	50	1	0.019607844	medium	3704
p07	bars	46	45	1	0.02173913	medium	3355
p07	bars	54	60	6	0.11111111	medium	2222
p07	bars	19	15	4	0.21052632	medium	2532
p07	bars	86	85	1	0.011627907	medium	5005
p07	bars	25	20	5	0.2	medium	3838
p07	bars	65	75	10	0.15384616	medium	2396
p07	bars	82	85	3	0.036585364	medium	4741
p07	bars	24	25	1	0.041666668	medium	3293
p07	bars	62	65	3	0.048387095	medium	2933
p07	bars	43	39	4	0.093023255	medium	7677
p07	bars	33	30	3	0.09090909	medium	5078
p07	bars	38	35	3	0.078947365	medium	2293
p07	bars	32	30	2	0.0625	medium	2680
p07	bars	15	15	0	0.0	medium	4058
p07	bars	33	30	3	0.09090909	medium	2590
p07	bars	12	15	3	0.25	medium	2478
p07	bars	79	80	1	0.012658228	medium	7285
p07	bars	59	69	10	0.16949153	medium	4429
p07	bars	11	10	1	0.09090909	medium	2405
p07	squarepie	53	53	0	0.0	medium	12155
p07	squarepie	90	90	0	0.0	high	2469
p07	squarepie	46	46	0	0.0	medium	5629
p07	squarepie	33	33	0	0.0	medium	3724
p07	squarepie	17	17	0	0.0	high	6053
p07	squarepie	88	88	0	0.0	medium	4350
p07	squarepie	63	63	0	0.0	medium	4388
p07	squarepie	30	30	0	0.0	high	3293
p07	squarepie	60	60	0	0.0	high	3725
p07	squarepie	66	56	10	0.15151516	medium	4913
p07	squarepie	82	72	10	0.12195122	medium	3628
p07	squarepie	44	44	0	0.0	medium	3591
p07	squarepie	72	72	0	0.0	high	5362
p07	squarepie	52	52	0	0.0	high	4077
p07	squarepie	35	35	0	0.0	high	3317
p07	squarepie	80	80	0	0.0	high	3917
p07	squarepie	37	38	1	0.027027028	medium	3693
p07	squarepie	12	12	0	0.0	high	2269
p07	squarepie	22	22	0	0.0	high	1845
p07	squarepie	62	62	0	0.0	high	3629
p07	donut	62	65	3	0.048387095	medium	7961
p07	donut	46	45	1	0.02173913	medium	3069
p07	donut	56	55	1	0.017857144	medium	1981
p07	donut	39	35	4	0.102564104	medium	2757
p07	donut	44	40	4	0.09090909	medium	3669
p07	donut	50	50	0	0.0	high	1893
p07	donut	24	24	0	0.0	medium	6389
p07	donut	61	65	4	0.06557377	medium	5229
p07	donut	73	73	0	0.0	medium	3133
p07	donut	29	30	1	0.03448276	medium	2629
p07	donut	20	15	5	0.25	medium	1965
p07	donut	31	30	1	0.032258064	medium	3292
p07	donut	48	45	3	0.0625	medium	3341
p07	donut	66	65	1	0.015151516	medium	4069
p07	donut	57	55	2	0.03508772	medium	1981
p07	donut	92	95	3	0.032608695	medium	3766
p07	donut	72	70	2	0.027777778	medium	2838
p07	donut	68	66	2	0.029411765	medium	5540
p07	donut	1	1	0	0.0	medium	1892
p07	donut	70	60	10	0.14285715	medium	2325
p08	squarepie	21	21	0	0.0	medium	32118
p08	squarepie	57	47	10	0.1754386	medium	20492
p08	squarepie	74	74	0	0.0	high	15345
p08	squarepie	84	84	0	0.0	high	11523
p08	squarepie	28	28	0	0.0	high	5690
p08	squarepie	71	71	0	0.0	high	8548
p08	squarepie	21	21	0	0.0	high	4575
p08	squarepie	48	48	0	0.0	high	24658
p08	squarepie	71	71	0	0.0	high	10195
p08	squarepie	35	35	0	0.0	medium	12350
p08	squarepie	96	96	0	0.0	high	4283
p08	squarepie	58	48	10	0.1724138	high	7792
p08	squarepie	44	34	10	0.22727273	medium	9276
p08	squarepie	74	74	0	0.0	medium	21377
p08	squarepie	12	12	0	0.0	high	3533
p08	squarepie	32	32	0	0.0	high	5110
p08	squarepie	41	31	10	0.24390244	high	14425
p08	squarepie	57	57	0	0.0	high	9174
p08	squarepie	8	8	0	0.0	high	4273
p08	squarepie	17	17	0	0.0	high	4265
p08	donut	54	55	1	0.018518519	medium	7126
p08	donut	28	30	2	0.071428575	medium	9296
p08	donut	31	35	4	0.12903225	medium	3265
p08	donut	77	80	3	0.038961038	medium	5345
p08	donut	53	55	2	0.03773585	medium	3528
p08	donut	23	20	3	0.13043478	medium	10520
p08	donut	43	40	3	0.069767445	medium	3662
p08	donut	53	55	2	0.03773585	medium	2923
p08	donut	83	80	3	0.036144577	medium	9401
p08	donut	10	10	0	0.0	medium	2501
p08	donut	92	90	2	0.02173913	medium	4308
p08	donut	71	70	1	0.014084507	medium	3168
p08	donut	45	45	0	0.0	medium	3267
p08	donut	3	5	2	0.6666667	medium	2757
p08	donut	80	80	0	0.0	medium	12163
p08	donut	21	20	1	0.04761905	medium	5787
p08	donut	32	30	2	0.0625	medium	2206
p08	donut	68	70	2	0.029411765	medium	4681
p08	donut	43	45	2	0.046511628	medium	7045
p08	donut	9	10	1	0.11111111	medium	3798
p08	bars	85	85	0	0.0	medium	17237
p08	bars	67	70	3	0.04477612	medium	5915
p08	bars	80	75	5	0.0625	medium	5922
p08	bars	44	45	1	0.022727273	medium	6831
p08	bars	99	98	1	0.01010101	high	6184
p08	bars	42	40	2	0.04761905	medium	5544
p08	bars	37	40	3	0.08108108	medium	2101
p08	bars	76	80	4	0.05263158	medium	12675
p08	bars	67	70	3	0.04477612	medium	6261
p08	bars	57	60	3	0.05263158	medium	3519
p08	bars	61	70	9	0.14754099	medium	2228
p08	bars	41	40	1	0.024390243	medium	4842
p08	bars	56	55	1	0.017857144	medium	2449
p08	bars	20	20	0	0.0	medium	2499
p08	bars	68	70	2	0.029411765	medium	6420
p08	bars	48	50	2	0.041666668	medium	2652
p08	bars	36	40	4	0.11111111	medium	2502
p08	bars	64	60	4	0.0625	medium	2286
p08	bars	56	50	6	0.10714286	medium	2131
p08	bars	74	60	14	0.1891892	medium	2002
p08	piechart	25	25	0	0.0	high	3436
p08	piechart	78	80	2	0.025641026	medium	10452
p08	piechart	30	35	5	0.16666667	medium	4115
p08	piechart	32	35	3	0.09375	medium	2176
p08	piechart	57	55	2	0.03508772	medium	11261
p08	piechart	74	70	4	0.054054055	medium	2391
p08	piechart	35	33	2	0.057142857	high	3860
p08	piechart	33	33	0	0.0	high	1995
p08	piechart	29	30	1	0.03448276	medium	3869
p08	piechart	77	75	2	0.025974026	medium	6525
p08	piechart	33	40	7	0.21212122	medium	8503
p08	piechart	71	60	11	0.15492958	medium	7445
p08	piechart	52	55	3	0.057692308	medium	5446
p08	piechart	48	50	2	0.041666668	medium	4538
p08	piechart	16	15	1	0.0625	medium	7088
p08	piechart	37	35	2	0.054054055	medium	12944
p08	piechart	58	60	2	0.03448276	medium	7797
p08	piechart	32	33	1	0.03125	medium	10396
p08	piechart	47	50	3	0.06382979	low	7833
p08	piechart	52	52	0	0.0	high	6407
p09	piechart	43	34	9	0.20930232	medium	9515
p09	piechart	56	55	1	0.017857144	high	8182
p09	piechart	99	98	1	0.01010101	high	6965
p09	piechart	68	65	3	0.04411765	medium	7483
p09	piechart	42	39	3	0.071428575	medium	8215
p09	piechart	84	85	1	0.011904762	medium	10035
p09	piechart	56	57	1	0.017857144	medium	10253
p09	piechart	54	54	0	0.0	medium	6178
p09	piechart	25	25	0	0.0	high	5657
p09	piechart	19	20	1	0.05263158	high	3450
p09	piechart	76	77	1	0.013157895	high	5415
p09	piechart	69	69	0	0.0	medium	8003
p09	piechart	58	60	2	0.03448276	medium	5963
p09	piechart	62	62	0	0.0	medium	5187
p09	piechart	58	58	0	0.0	medium	4617
p09	piechart	42	42	0	0.0	medium	5482
p09	piechart	68	70	2	0.029411765	medium	6905
p09	piechart	78	78	0	0.0	medium	6930
p09	piechart	32	30	2	0.0625	medium	11077
p09	piechart	93	90	3	0.032258064	medium	6325
p09	bars	36	35	1	0.027777778	medium	3682
p09	bars	55	55	0	0.0	medium	3310
p09	bars	14	20	6	0.42857143	medium	5700
p09	bars	68	60	8	0.11764706	high	4173
p09	bars	84	80	4	0.04761905	high	5303
p09	bars	55	50	5	0.09090909	high	2490
p09	bars	87	80	7	0.08045977	high	2743
p09	bars	22	25	3	0.13636364	high	3415
p09	bars	71	67	4	0.056338027	high	3960
p09	bars	34	33	1	0.029411765	high	3705
p09	bars	36	40	4	0.11111111	medium	5682
p09	bars	63	60	3	0.04761905	medium	4015
p09	bars	41	40	1	0.024390243	medium	7003
p09	bars	84	80	4	0.04761905	medium	3142
p09	bars	28	35	7	0.25	medium	3762
p09	bars	1	4	3	3.0	medium	4010
p09	bars	76	70	6	0.078947365	medium	4833
p09	bars	32	30	2	0.0625	medium	4825
p09	bars	64	60	4	0.0625	medium	3085
p09	bars	48	45	3	0.0625	high	4032
p09	donut	27	27	0	0.0	medium	4708
p09	donut	41	35	6	0.14634146	medium	9860
p09	donut	13	10	3	0.23076923	high	5563
p09	donut	53	53	0	0.0	high	2570
p09	donut	29	28	1	0.03448276	high	3190
p09	donut	15	12	3	0.2	medium	6185
p09	donut	54	53	1	0.018518519	medium	3520
p09	donut	87	85	2	0.022988506	medium	4462
p09	donut	82	82	0	0.0	medium	3848
p09	donut	58	55	3	0.05172414	medium	2282
p09	donut	99	98	1	0.01010101	high	2925
p09	donut	39	36	3	0.07692308	medium	7937
p09	donut	60	62	2	0.033333335	medium	3355
p09	donut	85	81	4	0.047058824	medium	3367
p09	donut	54	55	1	0.018518519	medium	4527
p09	donut	33	29	4	0.121212125	medium	5315
p09	donut	50	50	0	0.0	medium	2547
p09	donut	60	60	0	0.0	medium	2317
p09	donut	56	54	2	0.035714287	medium	3645
p09	donut	70	70	0	0.0	high	3687
p09	squarepie	17	17	0	0.0	high	7912
p09	squarepie	75	75	0	0.0	high	115037
p09	squarepie	60	60	0	0.0	high	4647
p09	squarepie	30	30	0	0.0	high	4052
p09	squarepie	1	1	0	0.0	high	4432
p09	squarepie	23	23	0	0.0	high	3032
p09	squarepie	34	34	0	0.0	high	6480
p09	squarepie	27	27	0	0.0	high	5133
p09	squarepie	43	43	0	0.0	high	6650
p09	squarepie	94	94	0	0.0	high	5787
p09	squarepie	50	50	0	0.0	high	2935
p09	squarepie	60	60	0	0.0	high	3010
p09	squarepie	7	7	0	0.0	high	3625
p09	squarepie	62	62	0	0.0	high	5177
p09	squarepie	75	75	0	0.0	high	4598
p09	squarepie	68	68	0	0.0	high	4870
p09	squarepie	21	21	0	0.0	high	2938
p09	squarepie	1	1	0	0.0	high	2942
p09	squarepie	61	61	0	0.0	high	6042
p09	squarepie	99	99	0	0.0	high	2555
p10	squarepie	13	13	0	0.0	high	45003
p10	squarepie	99	99	0	0.0	high	21064
p10	squarepie	61	61	0	0.0	medium	19204
p10	squarepie	13	13	0	0.0	high	6110
p10	squarepie	64	64	0	0.0	high	20188
p10	squarepie	52	52	0	0.0	high	7345
p10	squarepie	32	32	0	0.0	medium	18205
p10	squarepie	1	1	0	0.0	high	6781
p10	squarepie	67	67	0	0.0	high	13282
p10	squarepie	49	49	0	0.0	high	6470
p10	squarepie	51	51	0	0.0	high	3984
p10	squarepie	37	37	0	0.0	medium	11267
p10	squarepie	39	29	10	0.25641027	medium	19860
p10	squarepie	96	96	0	0.0	high	15111
p10	squarepie	66	66	0	0.0	high	10563
p10	squarepie	49	49	0	0.0	high	4641
p10	squarepie	2	2	0	0.0	high	3594
p10	squarepie	62	62	0	0.0	high	7031
p10	squarepie	87	87	0	0.0	high	21033
p10	squarepie	22	22	0	0.0	high	3906
p10	bars	32	30	2	0.0625	low	24908
p10	bars	84	84	0	0.0	low	15032
p10	bars	18	25	7	0.3888889	low	4234
p10	bars	78	76	2	0.025641026	low	10626
p10	bars	49	47	2	0.040816326	medium	7813
p10	bars	75	74	1	0.013333334	medium	10298
p10	bars	16	13	3	0.1875	low	13454
p10	bars	38	30	8	0.21052632	low	7500
p10	bars	7	10	3	0.42857143	low	6907
p10	bars	36	30	6	0.16666667	low	7532
p10	bars	85	82	3	0.03529412	low	4844
p10	bars	35	38	3	0.08571429	low	12266
p10	bars	28	26	2	0.071428575	medium	7844
p10	bars	63	55	8	0.12698413	medium	4938
p10	bars	91	90	1	0.010989011	medium	4547
p10	bars	42	40	2	0.04761905	medium	6688
p10	bars	40	39	1	0.025	medium	5141
p10	bars	29	27	2	0.06896552	low	6110
p10	bars	43	39	4	0.093023255	low	8406
p10	bars	79	77	2	0.025316456	low	8704
p10	piechart	70	70	0	0.0	medium	8563
p10	piechart	48	47	1	0.020833334	medium	11595
p10	piechart	73	72	1	0.01369863	medium	5516
p10	piechart	21	20	1	0.04761905	medium	18251
p10	piechart	49	48	1	0.020408163	medium	5297
p10	piechart	25	26	1	0.04	medium	7360
p10	piechart	67	70	3	0.04477612	medium	9375
p10	piechart	57	61	4	0.07017544	medium	6673
p10	piechart	5	5	0	0.0	medium	5875
p10	piechart	55	55	0	0.0	medium	4657
p10	piechart	14	14	0	0.0	medium	10157
p10	piechart	47	46	1	0.021276595	medium	9360
p10	piechart	10	11	1	0.1	medium	4094
p10	piechart	37	37	0	0.0	medium	13282
p10	piechart	99	98	1	0.01010101	medium	5250
p10	piechart	36	36	0	0.0	medium	10126
p10	piechart	23	22	1	0.04347826	medium	9203
p10	piechart	58	58	0	0.0	medium	7360
p10	piechart	42	42	0	0.0	medium	8548
p10	piechart	27	27	0	0.0	medium	5453
p10	donut	88	87	1	0.011363637	medium	19579
p10	donut	77	78	1	0.012987013	medium	8954
p10	donut	41	44	3	0.07317073	medium	13720
p10	donut	9	7	2	0.22222222	medium	5125
p10	donut	52	52	0	0.0	medium	4500
p10	donut	20	20	0	0.0	medium	6313
p10	donut	39	37	2	0.051282052	medium	10595
p10	donut	26	27	1	0.03846154	medium	4672
p10	donut	37	35	2	0.054054055	medium	6391
p10	donut	67	70	3	0.04477612	medium	7250
p10	donut	80	79	1	0.0125	medium	5141
p10	donut	44	47	3	0.06818182	medium	8032
p10	donut	28	27	1	0.035714287	medium	6438
p10	donut	81	79	2	0.024691358	medium	7063
p10	donut	67	71	4	0.05970149	medium	6078
p10	donut	34	32	2	0.05882353	medium	6673
p10	donut	49	48	1	0.020408163	medium	3547
p10	donut	29	27	2	0.06896552	medium	6469
p10	donut	46	47	1	0.02173913	medium	4766
p10	donut	1	1	0	0.0	medium	5047
p11	bars	73	73	0	0.0	medium	26333
p11	bars	60	61	1	0.016666668	medium	36135
p11	bars	66	63	3	0.045454547	medium	14744
p11	bars	49	48	1	0.020408163	medium	9367
p11	bars	70	69	1	0.014285714	medium	49376
p11	bars	28	27	1	0.035714287	medium	5528
p11	bars	67	60	7	0.104477614	medium	40343
p11	bars	54	52	2	0.037037037	medium	5879
p11	bars	43	45	2	0.046511628	medium	5047
p11	bars	40	40	0	0.0	medium	8416
p11	bars	16	13	3	0.1875	medium	13551
p11	bars	81	77	4	0.049382716	medium	8248
p11	bars	36	32	4	0.11111111	medium	6303
p11	bars	9	9	0	0.0	medium	6687
p11	bars	79	76	3	0.03797468	medium	16313
p11	bars	31	30	1	0.032258064	medium	5678
p11	bars	44	48	4	0.09090909	medium	3039
p11	bars	19	24	5	0.2631579	medium	7832
p11	bars	58	60	2	0.03448276	medium	22311
p11	bars	21	24	3	0.14285715	medium	7223
p11	squarepie	52	52	0	0.0	high	7468
p11	squarepie	39	39	0	0.0	high	7599
p11	squarepie	52	52	0	0.0	high	7624
p11	squarepie	41	41	0	0.0	high	6271
p11	squarepie	99	99	0	0.0	high	2504
p11	squarepie	1	1	0	0.0	high	2087
p11	squarepie	22	22	0	0.0	high	14056
p11	squarepie	32	32	0	0.0	high	2312
p11	squarepie	30	20	10	0.33333334	high	3711
p11	squarepie	33	33	0	0.0	high	10223
p11	squarepie	44	44	0	0.0	high	3712
p11	squarepie	35	35	0	0.0	high	8136
p11	squarepie	85	85	0	0.0	high	6975
p11	squarepie	87	86	1	0.011494253	high	2175
p11	squarepie	72	72	0	0.0	high	5712
p11	squarepie	42	42	0	0.0	high	4055
p11	squarepie	32	32	0	0.0	high	3712
p11	squarepie	88	88	0	0.0	high	5154
p11	squarepie	42	42	0	0.0	high	5790
p11	squarepie	59	59	0	0.0	high	3879
p11	piechart	70	63	7	0.1	medium	33366
p11	piechart	31	30	1	0.032258064	medium	18095
p11	piechart	58	56	2	0.03448276	medium	16520
p11	piechart	5	10	5	1.0	medium	25088
p11	piechart	80	78	2	0.025	medium	10800
p11	piechart	91	90	1	0.010989011	medium	25862
p11	piechart	52	52	0	0.0	medium	4328
p11	piechart	82	66	16	0.19512194	medium	15943
p11	piechart	50	50	0	0.0	high	3143
p11	piechart	74	74	0	0.0	high	6400
p11	piechart	48	48	0	0.0	high	5992
p11	piechart	57	56	1	0.01754386	medium	21000
p11	piechart	60	60	0	0.0	medium	8702
p11	piechart	65	63	2	0.03076923	medium	2911
p11	piechart	39	38	1	0.025641026	medium	33239
p11	piechart	56	58	2	0.035714287	medium	6154
p11	piechart	11	13	2	0.18181819	medium	13775
p11	piechart	1	1	0	0.0	medium	31183
p11	piechart	51	52	1	0.019607844	medium	2959
p11	piechart	2	2	0	0.0	medium	2271
p11	donut	47	48	1	0.021276595	medium	3213
p11	donut	71	73	2	0.028169014	medium	8439
p11	donut	29	27	2	0.06896552	medium	7887
p11	donut	76	76	0	0.0	medium	4263
p11	donut	91	83	8	0.08791209	medium	7343
p11	donut	95	90	5	0.05263158	medium	2736
p11	donut	79	80	1	0.012658228	medium	9030
p11	donut	81	83	2	0.024691358	medium	2704
p11	donut	21	30	9	0.42857143	medium	6752
p11	donut	18	18	0	0.0	medium	10671
p11	donut	58	58	0	0.0	medium	12255
p11	donut	25	25	0	0.0	high	3392
p11	donut	37	33	4	0.10810811	high	10216
p11	donut	39	37	2	0.051282052	medium	7192
p11	donut	64	66	2	0.03125	medium	5839
p11	donut	46	48	2	0.04347826	medium	3335
p11	donut	11	13	2	0.18181819	medium	5184
p11	donut	72	73	1	0.013888889	medium	5184
p11	donut	32	27	5	0.15625	medium	3967
p11	donut	60	58	2	0.033333335	medium	8431
p12	piechart	16	20	4	0.25	medium	40094
p12	piechart	48	47	1	0.020833334	high	27328
p12	piechart	69	70	1	0.014492754	high	19015
p12	piechart	28	28	0	0.0	high	30719
p12	piechart	99	98	1	0.01010101	high	30391
p12	piechart	34	30	4	0.11764706	medium	21219
p12	piechart	22	23	1	0.045454547	medium	13109
p12	piechart	65	65	0	0.0	high	6016
p12	piechart	21	20	1	0.04761905	medium	14500
p12	piechart	39	35	4	0.102564104	high	6531
p12	piechart	34	33	1	0.029411765	medium	22969
p12	piechart	9	12	3	0.33333334	high	22578
p12	piechart	51	53	2	0.039215688	high	13312
p12	piechart	5	8	3	0.6	high	8438
p12	piechart	52	54	2	0.03846154	high	9687
p12	piechart	82	80	2	0.024390243	high	7594
p12	piechart	29	30	1	0.03448276	high	5125
p12	piechart	65	65	0	0.0	high	11671
p12	piechart	89	85	4	0.04494382	medium	12938
p12	piechart	22	20	2	0.09090909	medium	5921
p12	donut	43	35	8	0.18604651	medium	11578
p12	donut	49	49	0	0.0	high	5407
p12	donut	54	53	1	0.018518519	high	3906
p12	donut	69	80	11	0.1594203	high	7375
p12	donut	62	70	8	0.12903225	medium	11906
p12	donut	20	20	0	0.0	high	7219
p12	donut	41	35	6	0.14634146	high	5015
p12	donut	37	30	7	0.1891892	high	3547
p12	donut	77	78	1	0.012987013	high	4484
p12	donut	29	26	3	0.10344828	high	4032
p12	donut	21	20	1	0.04761905	high	10906
p12	donut	52	55	3	0.057692308	high	8234
p12	donut	36	30	6	0.16666667	high	3672
p12	donut	20	12	8	0.4	high	2985
p12	donut	28	27	1	0.035714287	high	4078
p12	donut	38	29	9	0.23684211	high	5031
p12	donut	11	10	1	0.09090909	high	6875
p12	donut	19	12	7	0.36842105	high	4984
p12	donut	38	30	8	0.21052632	high	4328
p12	donut	9	8	1	0.11111111	medium	3704
p12	bars	5	10	5	1.0	high	4484
p12	bars	74	70	4	0.054054055	high	8594
p12	bars	17	15	2	0.11764706	high	2891
p12	bars	46	50	4	0.08695652	high	9390
p12	bars	99	85	14	0.14141414	high	4985
p12	bars	65	80	15	0.23076923	high	3609
p12	bars	19	20	1	0.05263158	high	18703
p12	bars	41	30	11	0.2682927	high	4500
p12	bars	55	53	2	0.036363635	high	3469
p12	bars	59	54	5	0.084745765	high	2937
p12	bars	52	50	2	0.03846154	high	6719
p12	bars	62	57	5	0.08064516	high	5781
p12	bars	11	12	1	0.09090909	high	2860
p12	bars	19	13	6	0.31578946	high	6234
p12	bars	23	13	10	0.4347826	high	5328
p12	bars	34	18	16	0.47058824	high	6985
p12	bars	64	65	1	0.015625	high	3922
p12	bars	45	50	5	0.11111111	high	2594
p12	bars	64	60	4	0.0625	high	2641
p12	bars	75	75	0	0.0	high	7500
p12	squarepie	30	40	10	0.33333334	high	7375
p12	squarepie	25	38	13	0.52	high	3141
p12	squarepie	30	30	0	0.0	high	3844
p12	squarepie	9	9	0	0.0	high	3859
p12	squarepie	23	34	11	0.47826087	high	4750
p12	squarepie	56	60	4	0.071428575	high	7391
p12	squarepie	29	28	1	0.03448276	high	12781
p12	squarepie	99	95	4	0.04040404	high	4812
p12	squarepie	61	61	0	0.0	high	3594
p12	squarepie	64	64	0	0.0	high	3297
p12	squarepie	59	59	0	0.0	high	3875
p12	squarepie	28	28	0	0.0	high	23797
p12	squarepie	65	55	10	0.15384616	high	2859
p12	squarepie	34	35	1	0.029411765	high	3000
p12	squarepie	20	20	0	0.0	high	2344
p12	squarepie	13	12	1	0.07692308	high	3109
p12	squarepie	72	63	9	0.125	high	3781
p12	squarepie	52	52	0	0.0	high	3766
p12	squarepie	15	15	0	0.0	high	3281
p12	squarepie	82	80	2	0.024390243	medium	17750
p13	bars	13	13	0	0.0	medium	25251
p13	bars	45	45	0	0.0	medium	7999
p13	bars	82	80	2	0.024390243	high	11114
p13	bars	5	8	3	0.6	medium	5798
p13	bars	99	98	1	0.01010101	high	6426
p13	bars	76	78	2	0.02631579	medium	16638
p13	bars	67	70	3	0.04477612	medium	6049
p13	bars	15	17	2	0.13333334	medium	7670
p13	bars	65	65	0	0.0	low	8190
p13	bars	17	20	3	0.1764706	medium	5692
p13	bars	75	75	0	0.0	medium	4376
p13	bars	68	65	3	0.04411765	medium	3667
p13	bars	81	80	1	0.012345679	medium	4254
p13	bars	58	55	3	0.05172414	high	3730
p13	bars	54	51	3	0.055555556	high	6621
p13	bars	57	52	5	0.0877193	high	5806
p13	bars	41	45	4	0.09756097	medium	3441
p13	bars	4	5	1	0.25	medium	2608
p13	bars	74	75	1	0.013513514	medium	3677
p13	bars	50	48	2	0.04	medium	3960
p13	donut	45	46	1	0.022222223	medium	5992
p13	donut	52	54	2	0.03846154	medium	4173
p13	donut	71	71	0	0.0	medium	5905
p13	donut	55	55	0	0.0	medium	2736
p13	donut	67	65	2	0.029850746	medium	11596
p13	donut	84	80	4	0.04761905	high	5456
p13	donut	72	72	0	0.0	high	5410
p13	donut	76	75	1	0.013157895	medium	13934
p13	donut	42	40	2	0.04761905	medium	7082
p13	donut	49	49	0	0.0	high	4485
p13	donut	81	80	1	0.012345679	medium	4107
p13	donut	25	25	0	0.0	high	4972
p13	donut	50	50	0	0.0	high	1952
p13	donut	10	10	0	0.0	medium	4927
p13	donut	70	70	0	0.0	medium	6590
p13	donut	41	42	1	0.024390243	medium	6943
p13	donut	11	15	4	0.36363637	medium	6566
p13	donut	52	52	0	0.0	medium	6884
p13	donut	83	80	3	0.036144577	high	4107
p13	donut	8	10	2	0.25	high	2684
p13	squarepie	55	55	0	0.0	high	7837
p13	squarepie	52	53	1	0.01923077	medium	5892
p13	squarepie	21	21	0	0.0	high	4944
p13	squarepie	76	76	0	0.0	medium	7148
p13	squarepie	70	70	0	0.0	high	3498
p13	squarepie	25	25	0	0.0	high	4638
p13	squarepie	1	2	1	1.0	medium	3146
p13	squarepie	80	80	0	0.0	high	5771
p13	squarepie	45	45	0	0.0	high	4117
p13	squarepie	16	16	0	0.0	medium	4988
p13	squarepie	99	99	0	0.0	high	2950
p13	squarepie	35	35	0	0.0	high	6226
p13	squarepie	33	33	0	0.0	high	2720
p13	squarepie	40	40	0	0.0	high	5680
p13	squarepie	89	89	0	0.0	high	7406
p13	squarepie	81	81	0	0.0	high	5176
p13	squarepie	25	25	0	0.0	high	3125
p13	squarepie	15	15	0	0.0	high	3499
p13	squarepie	34	34	0	0.0	high	3818
p13	squarepie	31	31	0	0.0	high	2392
p13	piechart	44	45	1	0.022727273	high	5877
p13	piechart	37	35	2	0.054054055	medium	6668
p13	piechart	26	27	1	0.03846154	medium	6856
p13	piechart	40	40	0	0.0	medium	7916
p13	piechart	62	55	7	0.11290322	medium	6537
p13	piechart	58	55	3	0.05172414	medium	5200
p13	piechart	49	49	0	0.0	medium	4129
p13	piechart	57	54	3	0.05263158	medium	4004
p13	piechart	49	49	0	0.0	medium	3582
p13	piechart	60	55	5	0.083333336	medium	3929
p13	piechart	41	45	4	0.09756097	medium	2367
p13	piechart	63	58	5	0.07936508	medium	6083
p13	piechart	79	78	1	0.012658228	medium	5322
p13	piechart	40	40	0	0.0	medium	8398
p13	piechart	97	96	1	0.010309278	high	5715
p13	piechart	39	38	1	0.025641026	medium	6501
p13	piechart	60	57	3	0.05	medium	5579
p13	piechart	15	16	1	0.06666667	medium	11348
p13	piechart	61	60	1	0.016393442	medium	2700
p13	piechart	9	10	1	0.11111111	medium	2308
p14	squarepie	74	84	10	0.13513513	medium	30477
p14	squarepie	18	22	4	0.22222222	medium	16764
p14	squarepie	14	18	4	0.2857143	medium	4298
p14	squarepie	50	50	0	0.0	high	3810
p14	squarepie	24	28	4	0.16666667	medium	5796
p14	squarepie	22	24	2	0.09090909	medium	4112
p14	squarepie	71	77	6	0.08450704	medium	5666
p14	squarepie	68	73	5	0.073529415	medium	3369
p14	squarepie	45	45	0	0.0	medium	3677
p14	squarepie	37	37	0	0.0	medium	7423
p14	squarepie	43	43	0	0.0	medium	2865
p14	squarepie	36	36	0	0.0	medium	4345
p14	squarepie	84	84	0	0.0	medium	8928
p14	squarepie	34	36	2	0.05882353	medium	5956
p14	squarepie	43	43	0	0.0	medium	3312
p14	squarepie	79	79	0	0.0	high	4830
p14	squarepie	53	53	0	0.0	medium	6360
p14	squarepie	58	58	0	0.0	medium	3527
p14	squarepie	45	46	1	0.022222223	medium	4009
p14	squarepie	35	35	0	0.0	high	5882
p14	bars	24	25	1	0.041666668	medium	6029
p14	bars	11	16	5	0.45454547	medium	8342
p14	bars	71	75	4	0.056338027	high	3967
p14	bars	57	59	2	0.03508772	medium	6636
p14	bars	25	27	2	0.08	medium	4462
p14	bars	86	80	6	0.069767445	medium	4017
p14	bars	54	50	4	0.074074075	medium	1921
p14	bars	62	57	5	0.08064516	medium	4243
p14	bars	42	45	3	0.071428575	medium	3663
p14	bars	1	2	1	1.0	high	4913
p14	bars	52	52	0	0.0	medium	3683
p14	bars	74	66	8	0.10810811	medium	4516
p14	bars	77	68	9	0.116883114	medium	2959
p14	bars	64	60	4	0.0625	medium	7045
p14	bars	1	2	1	1.0	medium	2707
p14	bars	57	62	5	0.0877193	medium	3211
p14	bars	54	59	5	0.09259259	medium	2831
p14	bars	1	2	1	1.0	medium	1850
p14	bars	37	34	3	0.08108108	medium	4889
p14	bars	49	50	1	0.020408163	high	2848
p14	donut	38	40	2	0.05263158	medium	18449
p14	donut	44	45	1	0.022727273	high	8438
p14	donut	73	73	0	0.0	high	5653
p14	donut	35	33	2	0.057142857	high	4528
p14	donut	63	66	3	0.04761905	high	3177
p14	donut	46	46	0	0.0	medium	6717
p14	donut	49	49	0	0.0	high	3352
p14	donut	67	66	1	0.014925373	medium	3005
p14	donut	1	2	1	1.0	medium	4341
p14	donut	11	15	4	0.36363637	medium	12193
p14	donut	54	55	1	0.018518519	high	5001
p14	donut	32	33	1	0.03125	medium	2103
p14	donut	69	66	3	0.04347826	medium	2487
p14	donut	99	98	1	0.01010101	medium	4964
p14	donut	53	52	1	0.018867925	medium	3574
p14	donut	25	25	0	0.0	high	4518
p14	donut	50	50	0	0.0	high	2057
p14	donut	99	98	1	0.01010101	medium	2951
p14	donut	33	33	0	0.0	medium	2671
p14	donut	52	52	0	0.0	medium	5015
p14	piechart	38	33	5	0.13157895	high	4550
p14	piechart	69	66	3	0.04347826	high	2839
p14	piechart	44	46	2	0.045454547	medium	6424
p14	piechart	59	58	1	0.016949153	medium	9676
p14	piechart	43	45	2	0.046511628	medium	5800
p14	piechart	34	33	1	0.029411765	high	2302
p14	piechart	78	80	2	0.025641026	medium	5306
p14	piechart	71	70	1	0.014084507	medium	3279
p14	piechart	64	66	2	0.03125	medium	4006
p14	piechart	28	28	0	0.0	medium	6172
p14	piechart	51	52	1	0.019607844	medium	3003
p14	piechart	60	66	6	0.1	medium	3535
p14	piechart	67	68	1	0.014925373	medium	3703
p14	piechart	43	45	2	0.046511628	medium	2694
p14	piechart	18	20	2	0.11111111	medium	3374
p14	piechart	78	78	0	0.0	medium	5707
p14	piechart	31	30	1	0.032258064	medium	4786
p14	piechart	77	78	1	0.012987013	medium	5420
p14	piechart	19	20	1	0.05263158	medium	3315
p14	piechart	68	66	2	0.029411765	medium	4436
p15	piechart	11	15	4	0.36363637	medium	21257
p15	piechart	66	40	26	0.3939394	medium	7199
p15	piechart	56	60	4	0.071428575	medium	11087
p15	piechart	64	60	4	0.0625	medium	11951
p15	piechart	1	2	1	1.0	medium	4303
p15	piechart	73	70	3	0.04109589	medium	4591
p15	piechart	44	45	1	0.022727273	medium	7887
p15	piechart	25	25	0	0.0	high	14223
p15	piechart	1	2	1	1.0	medium	3535
p15	piechart	77	80	3	0.038961038	medium	7743
p15	piechart	89	85	4	0.04494382	medium	12287
p15	piechart	9	15	6	0.6666667	medium	5183
p15	piechart	30	30	0	0.0	medium	4863
p15	piechart	37	35	2	0.054054055	medium	7871
p15	piechart	25	25	0	0.0	high	3487
p15	piechart	99	98	1	0.01010101	medium	4175
p15	piechart	29	35	6	0.20689656	medium	14879
p15	piechart	39	40	1	0.025641026	medium	2703
p15	piechart	46	45	1	0.02173913	medium	3007
p15	piechart	82	80	2	0.024390243	medium	5231
p15	donut	58	55	3	0.05172414	medium	11866
p15	donut	76	78	2	0.02631579	medium	10031
p15	donut	71	70	1	0.014084507	medium	4223
p15	donut	57	55	2	0.03508772	medium	4287
p15	donut	50	50	0	0.0	medium	4607
p15	donut	29	30	1	0.03448276	medium	6352
p15	donut	52	55	3	0.057692308	medium	2319
p15	donut	40	45	5	0.125	medium	3616
p15	donut	88	85	3	0.03409091	medium	7599
p15	donut	66	63	3	0.045454547	medium	13232
p15	donut	72	70	2	0.027777778	medium	3903
p15	donut	13	15	2	0.15384616	medium	4544
p15	donut	37	35	2	0.054054055	medium	5839
p15	donut	76	77	1	0.013157895	medium	3967
p15	donut	48	45	3	0.0625	medium	2911
p15	donut	26	27	1	0.03846154	medium	3760
p15	donut	67	60	7	0.104477614	medium	5039
p15	donut	62	60	2	0.032258064	medium	4399
p15	donut	29	30	1	0.03448276	medium	3375
p15	donut	20	20	0	0.0	medium	2911
p15	squarepie	37	35	2	0.054054055	medium	5066
p15	squarepie	17	17	0	0.0	medium	12495
p15	squarepie	56	56	0	0.0	low	6543
p15	squarepie	50	50	0	0.0	medium	3120
p15	squarepie	38	48	10	0.2631579	medium	5008
p15	squarepie	32	32	0	0.0	low	15327
p15	squarepie	30	30	0	0.0	low	2927
p15	squarepie	48	48	0	0.0	low	27808
p15	squarepie	26	26	0	0.0	low	12207
p15	squarepie	43	43	0	0.0	low	7824
p15	squarepie	68	68	0	0.0	low	7936
p15	squarepie	81	71	10	0.12345679	low	12192
p15	squarepie	28	38	10	0.35714287	medium	5359
p15	squarepie	41	41	0	0.0	low	8160
p15	squarepie	49	39	10	0.20408164	medium	13039
p15	squarepie	46	36	10	0.2173913	medium	7568
p15	squarepie	63	63	0	0.0	low	10975
p15	squarepie	57	57	0	0.0	medium	4704
p15	squarepie	19	19	0	0.0	medium	4159
p15	squarepie	45	35	10	0.22222222	medium	7008
p15	bars	69	75	6	0.08695652	low	10602
p15	bars	1	1	0	0.0	medium	3856
p15	bars	38	35	3	0.078947365	low	4544
p15	bars	99	98	1	0.01010101	low	3584
p15	bars	76	80	4	0.05263158	low	5615
p15	bars	45	45	0	0.0	medium	3055
p15	bars	30	33	3	0.1	low	8351
p15	bars	69	66	3	0.04347826	low	3072
p15	bars	11	15	4	0.36363637	low	3056
p15	bars	36	35	1	0.027777778	low	4608
p15	bars	57	55	2	0.03508772	low	4143
p15	bars	81	80	1	0.012345679	low	4127
p15	bars	74	70	4	0.054054055	low	7567
p15	bars	64	60	4	0.0625	low	4048
p15	bars	66	65	1	0.015151516	low	5936
p15	bars	64	60	4	0.0625	low	4847
p15	bars	82	80	2	0.024390243	low	3663
p15	bars	99	98	1	0.01010101	low	2351
p15	bars	1	2	1	1.0	low	2496
p15	bars	62	66	4	0.06451613	low	4863
p16	piechart	46	20	26	0.5652174	medium	45806
p16	piechart	91	90	1	0.010989011	high	26278
p16	piechart	31	20	11	0.3548387	medium	8381
p16	piechart	74	70	4	0.054054055	medium	22551
p16	piechart	81	80	1	0.012345679	medium	5314
p16	piechart	33	20	13	0.3939394	medium	3352
p16	piechart	57	55	2	0.03508772	high	11761
p16	piechart	85	80	5	0.05882353	medium	4917
p16	piechart	99	99	0	0.0	high	5282
p16	piechart	45	45	0	0.0	high	4999
p16	piechart	61	58	3	0.04918033	medium	8475
p16	piechart	8	10	2	0.25	high	9869
p16	piechart	99	99	0	0.0	high	8556
p16	piechart	46	45	1	0.02173913	high	4699
p16	piechart	84	78	6	0.071428575	high	12109
p16	piechart	1	1	0	0.0	high	2463
p16	piechart	54	55	1	0.018518519	medium	4741
p16	piechart	9	10	1	0.11111111	high	3891
p16	piechart	48	48	0	0.0	high	4447
p16	piechart	43	40	3	0.069767445	high	5177
p16	donut	58	60	2	0.03448276	medium	5567
p16	donut	41	40	1	0.024390243	medium	2573
p16	donut	31	30	1	0.032258064	medium	6722
p16	donut	99	99	0	0.0	high	3597
p16	donut	74	75	1	0.013513514	high	3410
p16	donut	99	99	0	0.0	high	2189
p16	donut	84	80	4	0.04761905	high	3153
p16	donut	13	20	7	0.53846157	high	2441
p16	donut	52	53	1	0.01923077	high	3814
p16	donut	47	49	2	0.04255319	high	2412
p16	donut	30	30	0	0.0	medium	5098
p16	donut	65	68	3	0.046153847	medium	7161
p16	donut	67	70	3	0.04477612	medium	2959
p16	donut	50	50	0	0.0	high	2906
p16	donut	70	68	2	0.028571429	medium	5783
p16	donut	57	54	3	0.05263158	medium	5127
p16	donut	52	53	1	0.01923077	high	4176
p16	donut	54	55	1	0.018518519	high	3246
p16	donut	22	32	10	0.45454547	medium	9969
p16	donut	73	68	5	0.06849315	medium	5598
p16	bars	64	60	4	0.0625	medium	7464
p16	bars	49	45	4	0.08163265	medium	3155
p16	bars	57	55	2	0.03508772	medium	2686
p16	bars	2	5	3	1.5	high	3436
p16	bars	30	33	3	0.1	medium	4516
p16	bars	71	65	6	0.08450704	high	5524
p16	bars	53	50	3	0.056603774	high	2054
p16	bars	50	45	5	0.1	high	2835
p16	bars	42	35	7	0.16666667	medium	6072
p16	bars	20	22	2	0.1	medium	5913
p16	bars	60	60	0	0.0	medium	2469
p16	bars	63	65	2	0.031746034	medium	2279
p16	bars	99	98	1	0.01010101	high	2750
p16	bars	66	65	1	0.015151516	medium	6899
p16	bars	89	90	1	0.011235955	medium	3197
p16	bars	62	64	2	0.032258064	medium	3696
p16	bars	54	50	4	0.074074075	high	3084
p16	bars	99	99	0	0.0	high	4176
p16	bars	97	95	2	0.020618556	high	2720
p16	bars	22	28	6	0.27272728	medium	3517
p16	squarepie	43	30	13	0.30232558	low	18549
p16	squarepie	66	75	9	0.13636364	low	3589
p16	squarepie	52	60	8	0.15384616	medium	4839
p16	squarepie	27	20	7	0.25925925	medium	21809
p16	squarepie	79	88	9	0.11392405	medium	12076
p16	squarepie	55	60	5	0.09090909	medium	2844
p16	squarepie	34	40	6	0.1764706	medium	3396
p16	squarepie	51	52	1	0.019607844	medium	14936
p16	squarepie	1	3	2	2.0	medium	3939
p16	squarepie	51	52	1	0.019607844	medium	2993
p16	squarepie	19	20	1	0.05263158	medium	7866
p16	squarepie	82	88	6	0.07317073	medium	5020
p16	squarepie	46	45	1	0.02173913	medium	2754
p16	squarepie	86	88	2	0.023255814	medium	6858
p16	squarepie	62	70	8	0.12903225	low	9184
p16	squarepie	31	30	1	0.032258064	medium	4399
p16	squarepie	91	94	3	0.032967035	medium	4456
p16	squarepie	79	79	0	0.0	medium	3217
p16	squarepie	30	20	10	0.33333334	high	2295
p16	squarepie	32	23	9	0.28125	medium	4870
p17	donut	88	90	2	0.022727273	high	147140
p17	donut	99	97	2	0.02020202	high	11356
p17	donut	16	10	6	0.375	medium	19220
p17	donut	40	20	20	0.5	medium	11606
p17	donut	62	60	2	0.032258064	high	21715
p17	donut	57	58	1	0.01754386	medium	5632
p17	donut	69	72	3	0.04347826	high	10280
p17	donut	74	75	1	0.013513514	high	3510
p17	donut	42	40	2	0.04761905	medium	13120
p17	donut	35	30	5	0.14285715	medium	7394
p17	donut	64	62	2	0.03125	medium	9859
p17	donut	41	45	4	0.09756097	medium	9626
p17	donut	52	52	0	0.0	high	7378
p17	donut	70	73	3	0.042857144	high	10889
p17	donut	44	45	1	0.022727273	medium	6537
p17	donut	57	55	2	0.03508772	high	3494
p17	donut	1	3	2	2.0	high	8798
p17	donut	77	77	0	0.0	high	6958
p17	donut	41	41	0	0.0	high	9298
p17	donut	67	68	1	0.014925373	medium	6240
p17	squarepie	93	93	0	0.0	high	17613
p17	squarepie	22	2	20	0.90909094	medium	10810
p17	squarepie	67	6	61	0.9104478	medium	12044
p17	squarepie	57	57	0	0.0	medium	10218
p17	squarepie	49	49	0	0.0	high	5475
p17	squarepie	70	70	0	0.0	high	5101
p17	squarepie	27	27	0	0.0	medium	7348
p17	squarepie	23	24	1	0.04347826	medium	4586
p17	squarepie	46	46	0	0.0	medium	8144
p17	squarepie	44	44	0	0.0	medium	3978
p17	squarepie	49	49	0	0.0	high	6318
p17	squarepie	38	38	0	0.0	medium	11856
p17	squarepie	54	54	0	0.0	high	7114
p17	squarepie	22	22	0	0.0	high	7628
p17	squarepie	83	84	1	0.012048192	medium	10374
p17	squarepie	76	76	0	0.0	medium	5351
p17	squarepie	21	21	0	0.0	high	4992
p17	squarepie	25	25	0	0.0	high	3042
p17	squarepie	47	47	0	0.0	medium	6443
p17	squarepie	4	4	0	0.0	high	7519
p17	bars	47	45	2	0.04255319	high	7067
p17	bars	52	50	2	0.03846154	high	2387
p17	bars	50	47	3	0.06	high	2340
p17	bars	39	35	4	0.102564104	medium	3089
p17	bars	65	65	0	0.0	medium	3369
p17	bars	99	97	2	0.02020202	high	5460
p17	bars	65	68	3	0.046153847	medium	11825
p17	bars	46	45	1	0.02173913	medium	3354
p17	bars	52	50	2	0.03846154	high	3229
p17	bars	99	97	2	0.02020202	high	6459
p17	bars	55	62	7	0.12727273	medium	3338
p17	bars	77	75	2	0.025974026	high	4633
p17	bars	1	3	2	2.0	high	4509
p17	bars	64	60	4	0.0625	medium	7051
p17	bars	60	58	2	0.033333335	medium	4852
p17	bars	99	97	2	0.02020202	high	5896
p17	bars	58	60	2	0.03448276	medium	5164
p17	bars	1	3	2	2.0	high	5242
p17	bars	58	65	7	0.12068965	medium	3198
p17	bars	40	42	2	0.05	medium	4352
p17	piechart	75	75	0	0.0	high	7956
p17	piechart	12	13	1	0.083333336	high	8643
p17	piechart	39	40	1	0.025641026	high	5007
p17	piechart	1	2	1	1.0	high	3978
p17	piechart	45	45	0	0.0	high	5304
p17	piechart	39	40	1	0.025641026	high	3167
p17	piechart	33	30	3	0.09090909	high	7519
p17	piechart	62	60	2	0.032258064	high	8206
p17	piechart	42	45	3	0.071428575	high	3104
p17	piechart	44	47	3	0.06818182	high	4571
p17	piechart	42	45	3	0.071428575	high	2527
p17	piechart	98	95	3	0.030612245	high	5023
p17	piechart	57	56	1	0.01754386	high	10265
p17	piechart	46	47	1	0.02173913	high	6615
p17	piechart	88	87	1	0.011363637	high	8860
p17	piechart	80	80	0	0.0	high	3635
p17	piechart	97	95	2	0.020618556	high	2871
p17	piechart	34	30	4	0.11764706	high	4196
p17	piechart	47	47	0	0.0	high	6287
p17	piechart	3	4	1	0.33333334	high	5803
p18	piechart	78	79	1	0.012820513	medium	25406
p18	piechart	24	24	0	0.0	high	12094
p18	piechart	40	38	2	0.05	medium	12656
p18	piechart	59	59	0	0.0	medium	20437
p18	piechart	99	98	1	0.01010101	high	5625
p18	piechart	4	5	1	0.25	high	6188
p18	piechart	24	24	0	0.0	high	3719
p18	piechart	56	57	1	0.017857144	medium	4875
p18	piechart	97	96	1	0.010309278	high	5750
p18	piechart	11	11	0	0.0	high	8921
p18	piechart	1	1	0	0.0	high	7797
p18	piechart	74	74	0	0.0	high	2985
p18	piechart	84	83	1	0.011904762	high	11625
p18	piechart	62	62	0	0.0	medium	8656
p18	piechart	47	45	2	0.04255319	medium	5141
p18	piechart	49	49	0	0.0	high	2875
p18	piechart	24	24	0	0.0	high	4687
p18	piechart	74	74	0	0.0	high	2984
p18	piechart	60	61	1	0.016666668	medium	7563
p18	piechart	90	89	1	0.011111111	medium	10031
p18	squarepie	20	20	0	0.0	high	5610
p18	squarepie	58	58	0	0.0	high	6718
p18	squarepie	65	65	0	0.0	high	8954
p18	squarepie	38	38	0	0.0	high	6640
p18	squarepie	36	36	0	0.0	high	3563
p18	squarepie	32	32	0	0.0	high	2562
p18	squarepie	43	43	0	0.0	high	4531
p18	squarepie	62	62	0	0.0	high	5079
p18	squarepie	1	1	0	0.0	high	2437
p18	squarepie	74	74	0	0.0	high	4734
p18	squarepie	1	1	0	0.0	high	2063
p18	squarepie	58	58	0	0.0	high	4031
p18	squarepie	60	60	0	0.0	high	2859
p18	squarepie	74	74	0	0.0	high	4750
p18	squarepie	86	86	0	0.0	high	3719
p18	squarepie	73	73	0	0.0	high	3297
p18	squarepie	22	22	0	0.0	high	3265
p18	squarepie	66	66	0	0.0	high	5469
p18	squarepie	70	70	0	0.0	high	2375
p18	squarepie	36	36	0	0.0	high	5235
p18	donut	21	20	1	0.04761905	medium	10688
p18	donut	54	55	1	0.018518519	medium	4672
p18	donut	47	46	1	0.021276595	medium	5281
p18	donut	2	3	1	0.5	high	6141
p18	donut	59	59	0	0.0	medium	7031
p18	donut	66	65	1	0.015151516	medium	9297
p18	donut	97	95	2	0.020618556	medium	7719
p18	donut	71	72	1	0.014084507	medium	6468
p18	donut	1	2	1	1.0	high	3875
p18	donut	69	70	1	0.014492754	medium	4328
p18	donut	75	75	0	0.0	high	3563
p18	donut	38	37	1	0.02631579	medium	7859
p18	donut	92	90	2	0.02173913	medium	8281
p18	donut	27	27	0	0.0	high	3422
p18	donut	99	98	1	0.01010101	high	2500
p18	donut	38	38	0	0.0	high	6047
p18	donut	43	42	1	0.023255814	medium	10641
p18	donut	60	61	1	0.016666668	medium	17515
p18	donut	14	13	1	0.071428575	medium	4328
p18	donut	37	37	0	0.0	medium	6844
p18	bars	36	35	1	0.027777778	low	24906
p18	bars	57	55	2	0.03508772	medium	6140
p18	bars	79	77	2	0.025316456	low	26719
p18	bars	1	2	1	1.0	high	3610
p18	bars	27	30	3	0.11111111	low	15234
p18	bars	1	2	1	1.0	medium	4781
p18	bars	40	42	2	0.05	medium	8750
p18	bars	60	58	2	0.033333335	low	7156
p18	bars	49	50	1	0.020408163	high	20422
p18	bars	88	85	3	0.03409091	low	19234
p18	bars	81	80	1	0.012345679	medium	10344
p18	bars	30	30	0	0.0	low	13781
p18	bars	53	54	1	0.018867925	medium	8610
p18	bars	93	92	1	0.010752688	medium	18937
p18	bars	30	30	0	0.0	medium	5922
p18	bars	45	42	3	0.06666667	medium	7250
p18	bars	2	5	3	1.5	medium	3031
p18	bars	47	47	0	0.0	high	12125
p18	bars	13	13	0	0.0	high	25641
p18	bars	61	60	1	0.016393442	medium	12219
p19	piechart	70	69	1	0.014285714	medium	30153
p19	piechart	61	60	1	0.016393442	medium	14830
p19	piechart	12	12	0	0.0	high	7983
p19	piechart	70	70	0	0.0	high	5063
p19	piechart	99	99	0	0.0	high	5735
p19	piechart	27	27	0	0.0	high	5376
p19	piechart	80	81	1	0.0125	high	20007
p19	piechart	76	77	1	0.013157895	high	3847
p19	piechart	72	74	2	0.027777778	high	3664
p19	piechart	65	63	2	0.03076923	high	17344
p19	piechart	77	76	1	0.012987013	high	6503
p19	piechart	46	47	1	0.02173913	high	4816
p19	piechart	81	81	0	0.0	high	8503
p19	piechart	26	26	0	0.0	high	4231
p19	piechart	52	52	0	0.0	high	3415
p19	piechart	40	37	3	0.075	medium	11255
p19	piechart	59	61	2	0.033898305	medium	7463
p19	piechart	24	23	1	0.041666668	high	5200
p19	piechart	73	73	0	0.0	high	4615
p19	piechart	45	43	2	0.044444446	high	20447
p19	bars	83	83	0	0.0	high	23641
p19	bars	22	20	2	0.09090909	medium	12896
p19	bars	72	70	2	0.027777778	medium	13608
p19	bars	19	15	4	0.21052632	medium	13543
p19	bars	69	75	6	0.08695652	high	9160
p19	bars	86	90	4	0.046511628	high	19015
p19	bars	45	40	5	0.11111111	medium	10344
p19	bars	66	70	4	0.060606062	medium	14648
p19	bars	42	40	2	0.04761905	medium	8488
p19	bars	57	55	2	0.03508772	medium	6231
p19	bars	73	75	2	0.02739726	medium	7176
p19	bars	29	30	1	0.03448276	medium	7336
p19	bars	24	25	1	0.041666668	high	5079
p19	bars	12	10	2	0.16666667	high	4791
p19	bars	26	20	6	0.23076923	medium	15888
p19	bars	47	45	2	0.04255319	medium	8552
p19	bars	51	50	1	0.019607844	high	2560
p19	bars	81	80	1	0.012345679	high	3831
p19	bars	25	25	0	0.0	high	5399
p19	bars	79	75	4	0.050632913	high	5192
p19	squarepie	65	65	0	0.0	high	18135
p19	squarepie	26	27	1	0.03846154	high	8663
p19	squarepie	30	30	0	0.0	high	3128
p19	squarepie	54	65	11	0.2037037	high	2807
p19	squarepie	52	63	11	0.21153846	high	2975
p19	squarepie	24	24	0	0.0	high	4568
p19	squarepie	35	35	0	0.0	high	3663
p19	squarepie	80	80	0	0.0	high	4568
p19	squarepie	21	21	0	0.0	high	3823
p19	squarepie	57	67	10	0.1754386	high	4407
p19	squarepie	83	83	0	0.0	high	5807
p19	squarepie	86	86	0	0.0	high	3399
p19	squarepie	56	66	10	0.17857143	high	4159
p19	squarepie	36	36	0	0.0	high	6479
p19	squarepie	8	8	0	0.0	high	3663
p19	squarepie	49	59	10	0.20408164	high	4863
p19	squarepie	60	60	0	0.0	high	3288
p19	squarepie	87	87	0	0.0	high	5871
p19	squarepie	53	53	0	0.0	high	6183
p19	squarepie	5	5	0	0.0	high	3239
p19	donut	40	37	3	0.075	high	6976
p19	donut	43	38	5	0.11627907	high	3191
p19	donut	73	70	3	0.04109589	high	3511
p19	donut	81	80	1	0.012345679	high	4231
p19	donut	17	17	0	0.0	high	5624
p19	donut	59	60	1	0.016949153	high	8023
p19	donut	46	45	1	0.02173913	high	3631
p19	donut	61	61	0	0.0	medium	6071
p19	donut	68	66	2	0.029411765	medium	8712
p19	donut	37	36	1	0.027027028	medium	7895
p19	donut	35	35	0	0.0	high	3263
p19	donut	84	82	2	0.023809524	medium	7128
p19	donut	71	72	1	0.014084507	high	4096
p19	donut	32	30	2	0.0625	medium	8144
p19	donut	41	37	4	0.09756097	medium	3424
p19	donut	58	58	0	0.0	medium	5165
p19	donut	48	48	0	0.0	high	5808
p19	donut	99	98	1	0.01010101	high	3015
p19	donut	77	76	1	0.012987013	high	3663
p19	donut	32	32	0	0.0	high	10559
p20	donut	88	82	6	0.06818182	high	104719
p20	donut	13	12	1	0.07692308	high	11312
p20	donut	89	82	7	0.07865169	high	15516
p20	donut	44	41	3	0.06818182	high	40578
p20	donut	5	9	4	0.8	medium	26781
p20	donut	64	62	2	0.03125	high	14391
p20	donut	60	58	2	0.033333335	medium	7172
p20	donut	9	10	1	0.11111111	medium	8297
p20	donut	1	1	0	0.0	high	3625
p20	donut	95	92	3	0.031578947	medium	31437
p20	donut	20	21	1	0.05	medium	24860
p20	donut	55	56	1	0.018181818	medium	12468
p20	donut	52	53	1	0.01923077	medium	7610
p20	donut	49	49	0	0.0	high	3531
p20	donut	44	42	2	0.045454547	medium	15250
p20	donut	57	58	1	0.01754386	medium	4094
p20	donut	52	53	1	0.01923077	high	4844
p20	donut	39	38	1	0.025641026	medium	10765
p20	donut	29	30	1	0.03448276	medium	5375
p20	donut	34	33	1	0.029411765	high	6016
p20	squarepie	70	70	0	0.0	high	24500
p20	squarepie	33	33	0	0.0	medium	19500
p20	squarepie	56	56	0	0.0	medium	10250
p20	squarepie	36	36	0	0.0	medium	10937
p20	squarepie	51	51	0	0.0	high	4016
p20	squarepie	16	16	0	0.0	high	6687
p20	squarepie	64	64	0	0.0	medium	38688
p20	squarepie	53	53	0	0.0	high	8703
p20	squarepie	42	42	0	0.0	medium	31062
p20	squarepie	33	34	1	0.030303031	medium	7016
p20	squarepie	70	70	0	0.0	high	14437
p20	squarepie	98	97	1	0.010204081	high	11907
p20	squarepie	53	53	0	0.0	medium	9890
p20	squarepie	16	16	0	0.0	high	5110
p20	squarepie	53	53	0	0.0	high	5421
p20	squarepie	42	42	0	0.0	medium	4610
p20	squarepie	92	92	0	0.0	high	6375
p20	squarepie	24	24	0	0.0	high	5625
p20	squarepie	75	75	0	0.0	high	8469
p20	squarepie	23	24	1	0.04347826	high	5281
p20	bars	22	22	0	0.0	medium	27750
p20	bars	28	30	2	0.071428575	medium	15828
p20	bars	57	69	12	0.21052632	low	117703
p20	bars	72	73	1	0.013888889	low	19437
p20	bars	99	99	0	0.0	high	5829
p20	bars	65	68	3	0.046153847	low	37109
p20	bars	20	18	2	0.1	low	14297
p20	bars	63	70	7	0.11111111	low	41312
p20	bars	17	18	1	0.05882353	low	29625
p20	bars	74	75	1	0.013513514	medium	21625
p20	bars	40	42	2	0.05	medium	28953
p20	bars	23	25	2	0.08695652	medium	18188
p20	bars	10	12	2	0.2	medium	6906
p20	bars	29	35	6	0.20689656	low	6109
p20	bars	47	46	1	0.021276595	medium	10531
p20	bars	74	72	2	0.027027028	medium	19266
p20	bars	38	42	4	0.10526316	medium	23938
p20	bars	44	48	4	0.09090909	medium	4421
p20	bars	52	50	2	0.03846154	high	3891
p20	bars	27	33	6	0.22222222	medium	6656
p20	piechart	96	95	1	0.010416667	high	11266
p20	piechart	25	25	0	0.0	high	7141
p20	piechart	48	48	0	0.0	high	3391
p20	piechart	51	51	0	0.0	high	3250
p20	piechart	65	67	2	0.03076923	high	5625
p20	piechart	99	98	1	0.01010101	high	4203
p20	piechart	19	20	1	0.05263158	medium	10140
p20	piechart	50	50	0	0.0	high	2453
p20	piechart	74	73	1	0.013513514	high	6204
p20	piechart	63	67	4	0.06349207	high	4281
p20	piechart	56	58	2	0.035714287	high	6500
p20	piechart	34	35	1	0.029411765	medium	11109
p20	piechart	49	48	1	0.020408163	high	3141
p20	piechart	43	41	2	0.046511628	medium	11500
p20	piechart	85	85	0	0.0	medium	7703
p20	piechart	55	56	1	0.018181818	high	5859
p20	piechart	76	76	0	0.0	high	4078
p20	piechart	63	67	4	0.06349207	high	5063
p20	piechart	49	49	0	0.0	high	2453
p20	piechart	41	39	2	0.048780486	medium	15640
p21	piechart	37	37	0	0.0	medium	19779
p21	piechart	30	28	2	0.06666667	medium	10959
p21	piechart	46	46	0	0.0	medium	7471
p21	piechart	99	98	1	0.01010101	high	11263
p21	piechart	36	36	0	0.0	medium	12702
p21	piechart	33	34	1	0.030303031	medium	4015
p21	piechart	10	10	0	0.0	medium	14751
p21	piechart	56	54	2	0.035714287	high	6159
p21	piechart	35	34	1	0.028571429	medium	11343
p21	piechart	83	84	1	0.012048192	medium	10512
p21	piechart	63	66	3	0.04761905	medium	7088
p21	piechart	25	25	0	0.0	high	5583
p21	piechart	68	65	3	0.04411765	medium	7103
p21	piechart	62	62	0	0.0	medium	8127
p21	piechart	34	35	1	0.029411765	medium	6080
p21	piechart	60	62	2	0.033333335	medium	11200
p21	piechart	37	37	0	0.0	medium	15998
p21	piechart	43	41	2	0.046511628	medium	15391
p21	piechart	67	66	1	0.014925373	medium	9039
p21	piechart	62	61	1	0.016129032	medium	5823
p21	donut	61	60	1	0.016393442	medium	17536
p21	donut	71	71	0	0.0	medium	5807
p21	donut	68	68	0	0.0	medium	7950
p21	donut	13	15	2	0.15384616	medium	4367
p21	donut	66	66	0	0.0	medium	3807
p21	donut	21	20	1	0.04761905	medium	4000
p21	donut	69	70	1	0.014492754	medium	9807
p21	donut	44	42	2	0.045454547	medium	14687
p21	donut	46	43	3	0.06521739	medium	2575
p21	donut	8	8	0	0.0	medium	12094
p21	donut	91	89	2	0.021978023	medium	7279
p21	donut	53	53	0	0.0	medium	4128
p21	donut	29	28	1	0.03448276	medium	7296
p21	donut	55	55	0	0.0	medium	10831
p21	donut	36	35	1	0.027777778	medium	13007
p21	donut	30	30	0	0.0	medium	6864
p21	donut	49	49	0	0.0	high	10463
p21	donut	13	12	1	0.07692308	medium	11376
p21	donut	38	36	2	0.05263158	medium	16272
p21	donut	61	61	0	0.0	medium	10781
p21	bars	51	48	3	0.05882353	medium	3980
p21	bars	36	36	0	0.0	medium	7215
p21	bars	83	81	2	0.024096385	medium	7807
p21	bars	49	50	1	0.020408163	high	3711
p21	bars	75	70	5	0.06666667	medium	5663
p21	bars	50	50	0	0.0	medium	4480
p21	bars	75	68	7	0.093333334	medium	6447
p21	bars	49	50	1	0.020408163	medium	2911
p21	bars	70	60	10	0.14285715	medium	2704
p21	bars	44	45	1	0.022727273	medium	5615
p21	bars	74	73	1	0.013513514	low	7455
p21	bars	61	62	1	0.016393442	low	4432
p21	bars	48	48	0	0.0	medium	4784
p21	bars	65	63	2	0.03076923	low	6831
p21	bars	34	38	4	0.11764706	low	8190
p21	bars	75	81	6	0.08	low	5518
p21	bars	99	98	1	0.01010101	high	6031
p21	bars	55	57	2	0.036363635	medium	5455
p21	bars	99	98	1	0.01010101	high	3168
p21	bars	14	16	2	0.14285715	medium	9262
p21	squarepie	15	15	0	0.0	high	22044
p21	squarepie	50	50	0	0.0	high	1839
p21	squarepie	86	86	0	0.0	high	9310
p21	squarepie	36	37	1	0.027777778	high	4975
p21	squarepie	57	57	0	0.0	high	4015
p21	squarepie	28	28	0	0.0	high	3455
p21	squarepie	23	24	1	0.04347826	high	2128
p21	squarepie	19	19	0	0.0	high	3408
p21	squarepie	22	23	1	0.045454547	high	4750
p21	squarepie	55	55	0	0.0	high	7567
p21	squarepie	29	29	0	0.0	high	2415
p21	squarepie	51	51	0	0.0	high	2655
p21	squarepie	80	80	0	0.0	high	2479
p21	squarepie	37	37	0	0.0	high	8686
p21	squarepie	72	72	0	0.0	high	3584
p21	squarepie	42	42	0	0.0	high	4286
p21	squarepie	25	25	0	0.0	high	2719
p21	squarepie	55	55	0	0.0	high	2543
p21	squarepie	90	90	0	0.0	high	2414
p21	squarepie	23	23	0	0.0	high	3903
p22	bars	69	60	9	0.13043478	medium	14563
p22	bars	72	75	3	0.041666668	medium	35828
p22	bars	60	60	0	0.0	medium	17687
p22	bars	34	40	6	0.1764706	medium	6844
p22	bars	69	75	6	0.08695652	medium	5172
p22	bars	19	20	1	0.05263158	medium	3984
p22	bars	43	45	2	0.046511628	medium	6094
p22	bars	3	5	2	0.6666667	medium	3219
p22	bars	29	25	4	0.13793103	medium	9406
p22	bars	99	95	4	0.04040404	medium	3594
p22	bars	31	30	1	0.032258064	medium	3359
p22	bars	47	50	3	0.06382979	medium	3094
p22	bars	52	55	3	0.057692308	medium	4563
p22	bars	18	15	3	0.16666667	medium	4843
p22	bars	25	20	5	0.2	medium	2125
p22	bars	40	40	0	0.0	medium	4063
p22	bars	32	30	2	0.0625	medium	1969
p22	bars	48	50	2	0.041666668	medium	4500
p22	bars	99	95	4	0.04040404	medium	2421
p22	bars	78	80	2	0.025641026	medium	2657
p22	piechart	69	60	9	0.13043478	medium	15250
p22	piechart	48	45	3	0.0625	medium	5844
p22	piechart	50	50	0	0.0	high	2281
p22	piechart	32	33	1	0.03125	high	8172
p22	piechart	29	30	1	0.03448276	medium	3562
p22	piechart	13	12	1	0.07692308	medium	11563
p22	piechart	51	52	1	0.019607844	medium	5687
p22	piechart	68	70	2	0.029411765	medium	3438
p22	piechart	46	40	6	0.13043478	medium	2812
p22	piechart	43	40	3	0.069767445	medium	3641
p22	piechart	47	42	5	0.10638298	medium	5234
p22	piechart	24	22	2	0.083333336	medium	5079
p22	piechart	82	80	2	0.024390243	medium	6437
p22	piechart	32	30	2	0.0625	medium	2766
p22	piechart	83	70	13	0.15662651	medium	7609
p22	piechart	24	22	2	0.083333336	medium	4297
p22	piechart	29	27	2	0.06896552	medium	3094
p22	piechart	41	37	4	0.09756097	medium	4937
p22	piechart	37	35	2	0.054054055	medium	3156
p22	piechart	60	60	0	0.0	medium	6969
p22	donut	95	90	5	0.05263158	medium	8797
p22	donut	43	45	2	0.046511628	medium	5625
p22	donut	75	75	0	0.0	high	3828
p22	donut	94	90	4	0.04255319	medium	5578
p22	donut	56	55	1	0.017857144	medium	4219
p22	donut	14	25	11	0.78571427	medium	4703
p22	donut	59	60	1	0.016949153	medium	85844
p22	donut	26	27	1	0.03846154	medium	5359
p22	donut	52	52	0	0.0	medium	3578
p22	donut	42	40	2	0.04761905	medium	5266
p22	donut	76	78	2	0.02631579	medium	7047
p22	donut	22	22	0	0.0	medium	3609
p22	donut	39	33	6	0.15384616	medium	7312
p22	donut	63	60	3	0.04761905	medium	6110
p22	donut	89	80	9	0.101123594	medium	5250
p22	donut	73	72	1	0.01369863	medium	3859
p22	donut	99	98	1	0.01010101	medium	3765
p22	donut	32	28	4	0.125	medium	3734
p22	donut	54	53	1	0.018518519	medium	3469
p22	donut	74	72	2	0.027027028	medium	5156
p22	squarepie	27	27	0	0.0	medium	19719
p22	squarepie	80	80	0	0.0	high	6297
p22	squarepie	46	47	1	0.02173913	medium	25125
p22	squarepie	43	43	0	0.0	medium	5219
p22	squarepie	22	23	1	0.045454547	medium	3437
p22	squarepie	67	67	0	0.0	medium	21297
p22	squarepie	99	99	0	0.0	high	11859
p22	squarepie	29	29	0	0.0	high	5188
p22	squarepie	38	38	0	0.0	high	5890
p22	squarepie	32	32	0	0.0	high	4610
p22	squarepie	23	23	0	0.0	medium	4375
p22	squarepie	63	63	0	0.0	medium	24187
p22	squarepie	61	61	0	0.0	high	6657
p22	squarepie	11	11	0	0.0	high	2312
p22	squarepie	57	57	0	0.0	high	9844
p22	squarepie	30	30	0	0.0	medium	7515
p22	squarepie	24	24	0	0.0	high	5485
p22	squarepie	99	99	0	0.0	high	2672
p22	squarepie	65	65	0	0.0	high	12625
p22	squarepie	27	27	0	0.0	high	6765
p23	squarepie	44	45	1	0.022727273	medium	4032
p23	squarepie	49	48	1	0.020408163	medium	5249
p23	squarepie	52	52	0	0.0	medium	2969
p23	squarepie	22	22	0	0.0	medium	4813
p23	squarepie	7	7	0	0.0	medium	3984
p23	squarepie	35	35	0	0.0	medium	5328
p23	squarepie	77	78	1	0.012987013	medium	3390
p23	squarepie	35	30	5	0.14285715	medium	4032
p23	squarepie	58	65	7	0.12068965	medium	2875
p23	squarepie	72	78	6	0.083333336	medium	2859
p23	squarepie	29	30	1	0.03448276	medium	4984
p23	squarepie	1	1	0	0.0	medium	1859
p23	squarepie	99	99	0	0.0	medium	1625
p23	squarepie	1	1	0	0.0	medium	1532
p23	squarepie	99	99	0	0.0	medium	1922
p23	squarepie	73	78	5	0.06849315	medium	2765
p23	squarepie	48	48	0	0.0	medium	2813
p23	squarepie	55	56	1	0.018181818	medium	3703
p23	squarepie	31	31	0	0.0	medium	3203
p23	squarepie	21	21	0	0.0	medium	2718
p23	bars	62	70	8	0.12903225	medium	3266
p23	bars	47	50	3	0.06382979	medium	1671
p23	bars	49	50	1	0.020408163	medium	2110
p23	bars	56	55	1	0.017857144	medium	2031
p23	bars	73	75	2	0.02739726	medium	2031
p23	bars	43	45	2	0.046511628	medium	2125
p23	bars	63	65	2	0.031746034	medium	1781
p23	bars	46	45	1	0.02173913	medium	3141
p23	bars	35	40	5	0.14285715	medium	2562
p23	bars	54	60	6	0.11111111	medium	2750
p23	bars	62	65	3	0.048387095	medium	1922
p23	bars	55	60	5	0.09090909	medium	2203
p23	bars	35	35	0	0.0	medium	2844
p23	bars	82	80	2	0.024390243	medium	1968
p23	bars	67	65	2	0.029850746	medium	2500
p23	bars	48	50	2	0.041666668	medium	2781
p23	bars	21	25	4	0.1904762	medium	2828
p23	bars	73	75	2	0.02739726	medium	1969
p23	bars	20	25	5	0.25	medium	1797
p23	bars	95	95	0	0.0	medium	2906
p23	piechart	89	80	9	0.101123594	medium	2063
p23	piechart	85	80	5	0.05882353	medium	8093
p23	piechart	49	49	0	0.0	medium	5422
p23	piechart	44	45	1	0.022727273	medium	2734
p23	piechart	99	98	1	0.01010101	medium	2156
p23	piechart	37	35	2	0.054054055	medium	5094
p23	piechart	78	80	2	0.025641026	medium	3344
p23	piechart	21	20	1	0.04761905	medium	2375
p23	piechart	44	45	1	0.022727273	medium	2094
p23	piechart	14	16	2	0.14285715	medium	10390
p23	piechart	80	80	0	0.0	medium	9703
p23	piechart	49	48	1	0.020408163	medium	3359
p23	piechart	61	60	1	0.016393442	medium	2469
p23	piechart	79	80	1	0.012658228	medium	1828
p23	piechart	57	55	2	0.03508772	medium	3594
p23	piechart	23	20	3	0.13043478	medium	2359
p23	piechart	69	65	4	0.057971016	medium	3937
p23	piechart	80	80	0	0.0	medium	1969
p23	piechart	40	40	0	0.0	medium	3813
p23	piechart	67	65	2	0.029850746	medium	3937
p23	donut	51	52	1	0.019607844	medium	3594
p23	donut	37	35	2	0.054054055	medium	5406
p23	donut	1	2	1	1.0	medium	1797
p23	donut	57	60	3	0.05263158	medium	3671
p23	donut	44	45	1	0.022727273	medium	1907
p23	donut	30	30	0	0.0	medium	3671
p23	donut	65	65	0	0.0	medium	5407
p23	donut	60	60	0	0.0	medium	2343
p23	donut	54	55	1	0.018518519	medium	2110
p23	donut	68	65	3	0.04411765	medium	4296
p23	donut	55	55	0	0.0	medium	1766
p23	donut	76	75	1	0.013157895	medium	2156
p23	donut	27	28	1	0.037037037	medium	2391
p23	donut	48	48	0	0.0	medium	2297
p23	donut	71	68	3	0.04225352	medium	2765
p23	donut	57	60	3	0.05263158	medium	2641
p23	donut	31	30	1	0.032258064	medium	2140
p23	donut	25	25	0	0.0	medium	1938
p23	donut	68	65	3	0.04411765	medium	1922
p23	donut	42	40	2	0.04761905	medium	3125
p24	squarepie	69	69	0	0.0	high	25031
p24	squarepie	75	75	0	0.0	medium	22453
p24	squarepie	44	44	0	0.0	high	12688
p24	squarepie	38	38	0	0.0	high	16672
p24	squarepie	57	57	0	0.0	high	5562
p24	squarepie	25	25	0	0.0	high	5407
p24	squarepie	71	71	0	0.0	high	6953
p24	squarepie	41	41	0	0.0	medium	13343
p24	squarepie	45	45	0	0.0	medium	4766
p24	squarepie	26	26	0	0.0	medium	10656
p24	squarepie	37	37	0	0.0	medium	6125
p24	squarepie	18	18	0	0.0	high	8328
p24	squarepie	75	75	0	0.0	high	6485
p24	squarepie	65	65	0	0.0	high	2594
p24	squarepie	68	68	0	0.0	high	4953
p24	squarepie	45	45	0	0.0	high	2484
p24	squarepie	51	51	0	0.0	high	1781
p24	squarepie	74	65	9	0.12162162	medium	10125
p24	squarepie	54	54	0	0.0	high	5235
p24	squarepie	32	32	0	0.0	medium	5531
p24	bars	33	35	2	0.060606062	medium	5593
p24	bars	68	70	2	0.029411765	medium	3594
p24	bars	74	75	1	0.013513514	high	2344
p24	bars	21	25	4	0.1904762	high	1797
p24	bars	37	40	3	0.08108108	medium	6047
p24	bars	79	75	4	0.050632913	high	2140
p24	bars	45	45	0	0.0	medium	2594
p24	bars	48	50	2	0.041666668	medium	4797
p24	bars	18	20	2	0.11111111	medium	3312
p24	bars	48	50	2	0.041666668	medium	5734
p24	bars	68	65	3	0.04411765	medium	3954
p24	bars	48	50	2	0.041666668	medium	4781
p24	bars	20	25	5	0.25	medium	2578
p24	bars	65	65	0	0.0	medium	4890
p24	bars	60	60	0	0.0	medium	4375
p24	bars	73	75	2	0.02739726	high	2563
p24	bars	87	85	2	0.022988506	medium	5297
p24	bars	36	40	4	0.11111111	medium	3531
p24	bars	66	65	1	0.015151516	medium	3359
p24	bars	72	60	12	0.16666667	medium	1516
p24	donut	65	66	1	0.015384615	medium	5407
p24	donut	62	60	2	0.032258064	medium	6078
p24	donut	36	33	3	0.083333336	medium	2515
p24	donut	62	60	2	0.032258064	medium	7313
p24	donut	99	99	0	0.0	high	3969
p24	donut	88	85	3	0.03409091	medium	8781
p24	donut	8	5	3	0.375	medium	3234
p24	donut	95	95	0	0.0	medium	2735
p24	donut	68	70	2	0.029411765	medium	3156
p24	donut	43	40	3	0.069767445	medium	4000
p24	donut	52	52	0	0.0	medium	5531
p24	donut	93	91	2	0.021505376	medium	3625
p24	donut	27	27	0	0.0	high	7500
p24	donut	29	29	0	0.0	high	3125
p24	donut	52	52	0	0.0	high	4844
p24	donut	17	15	2	0.11764706	medium	6640
p24	donut	48	48	0	0.0	medium	5204
p24	donut	29	27	2	0.06896552	medium	3765
p24	donut	33	30	3	0.09090909	medium	2360
p24	donut	1	1	0	0.0	high	3281
p24	piechart	56	55	1	0.017857144	high	7375
p24	piechart	34	33	1	0.029411765	high	2500
p24	piechart	30	30	0	0.0	medium	2156
p24	piechart	58	58	0	0.0	medium	4875
p24	piechart	23	20	3	0.13043478	medium	6469
p24	piechart	99	99	0	0.0	high	2406
p24	piechart	54	53	1	0.018518519	high	4375
p24	piechart	49	48	1	0.020408163	high	2187
p24	piechart	21	20	1	0.04761905	high	4813
p24	piechart	63	60	3	0.04761905	medium	6765
p24	piechart	66	66	0	0.0	high	4485
p24	piechart	23	23	0	0.0	high	2985
p24	piechart	42	45	3	0.071428575	high	6828
p24	piechart	1	2	1	1.0	high	1969
p24	piechart	29	30	1	0.03448276	high	4328
p24	piechart	37	33	4	0.10810811	high	4812
p24	piechart	54	53	1	0.018518519	high	5703
p24	piechart	27	27	0	0.0	high	2797
p24	piechart	49	48	1	0.020408163	high	2157
p24	piechart	65	66	1	0.015384615	high	4171
p25	squarepie	48	48	0	0.0	high	8828
p25	squarepie	43	43	0	0.0	high	8578
p25	squarepie	40	40	0	0.0	high	8203
p25	squarepie	26	26	0	0.0	high	13234
p25	squarepie	63	63	0	0.0	high	10032
p25	squarepie	99	99	0	0.0	high	4109
p25	squarepie	89	89	0	0.0	high	9609
p25	squarepie	65	65	0	0.0	high	19360
p25	squarepie	53	53	0	0.0	high	7969
p25	squarepie	15	15	0	0.0	high	3531
p25	squarepie	60	60	0	0.0	high	6484
p25	squarepie	44	44	0	0.0	high	8438
p25	squarepie	63	63	0	0.0	high	7297
p25	squarepie	65	65	0	0.0	high	5187
p25	squarepie	43	43	0	0.0	high	7031
p25	squarepie	60	60	0	0.0	high	6297
p25	squarepie	33	33	0	0.0	high	5235
p25	squarepie	76	76	0	0.0	high	7953
p25	squarepie	23	23	0	0.0	high	8437
p25	squarepie	43	43	0	0.0	high	6391
p25	donut	1	1	0	0.0	medium	4859
p25	donut	66	63	3	0.045454547	high	34203
p25	donut	87	88	1	0.011494253	high	16297
p25	donut	44	44	0	0.0	high	37468
p25	donut	1	1	0	0.0	high	4547
p25	donut	19	19	0	0.0	high	18282
p25	donut	55	56	1	0.018181818	high	8531
p25	donut	49	49	0	0.0	high	4515
p25	donut	45	47	2	0.044444446	high	4188
p25	donut	74	74	0	0.0	high	8125
p25	donut	55	54	1	0.018181818	medium	16031
p25	donut	46	47	1	0.02173913	high	8750
p25	donut	34	35	1	0.029411765	medium	24969
p25	donut	93	91	2	0.021505376	high	39578
p25	donut	41	42	1	0.024390243	high	9781
p25	donut	92	92	0	0.0	high	11406
p25	donut	54	53	1	0.018518519	high	8328
p25	donut	78	77	1	0.012820513	high	8734
p25	donut	50	50	0	0.0	high	3891
p25	donut	95	94	1	0.010526316	high	18469
p25	bars	83	80	3	0.036144577	medium	92781
p25	bars	48	45	3	0.0625	medium	21485
p25	bars	99	98	1	0.01010101	high	6515
p25	bars	31	33	2	0.06451613	medium	32063
p25	bars	1	2	1	1.0	high	3719
p25	bars	68	65	3	0.04411765	medium	19171
p25	bars	4	4	0	0.0	medium	10454
p25	bars	42	40	2	0.04761905	medium	34578
p25	bars	7	8	1	0.14285715	medium	29875
p25	bars	62	60	2	0.032258064	medium	11828
p25	bars	19	17	2	0.10526316	medium	24984
p25	bars	66	70	4	0.060606062	medium	17313
p25	bars	54	55	1	0.018518519	medium	5000
p25	bars	45	43	2	0.044444446	medium	7078
p25	bars	25	18	7	0.28	medium	22704
p25	bars	63	60	3	0.04761905	medium	15468
p25	bars	31	30	1	0.032258064	high	13719
p25	bars	70	66	4	0.057142857	medium	10469
p25	bars	78	78	0	0.0	medium	8797
p25	bars	45	40	5	0.11111111	medium	14281
p25	piechart	73	73	0	0.0	high	9516
p25	piechart	28	28	0	0.0	high	6953
p25	piechart	37	38	1	0.027027028	high	13453
p25	piechart	43	43	0	0.0	high	11110
p25	piechart	33	33	0	0.0	high	18468
p25	piechart	66	63	3	0.045454547	high	8485
p25	piechart	44	44	0	0.0	high	14593
p25	piechart	34	33	1	0.029411765	high	10657
p25	piechart	79	81	2	0.025316456	high	8750
p25	piechart	47	47	0	0.0	high	6140
p25	piechart	72	72	0	0.0	high	6282
p25	piechart	47	48	1	0.021276595	high	5297
p25	piechart	67	67	0	0.0	medium	14344
p25	piechart	63	63	0	0.0	high	5219
p25	piechart	28	28	0	0.0	high	6687
p25	piechart	43	42	1	0.023255814	medium	7188
p25	piechart	39	38	1	0.025641026	medium	15281
p25	piechart	65	63	2	0.03076923	high	4687
p25	piechart	43	43	0	0.0	high	8610
p25	piechart	88	88	0	0.0	high	242000
p26	bars	28	28	0	0.0	high	57793
p26	bars	43	45	2	0.046511628	medium	8722
p26	bars	48	48	0	0.0	medium	9445
p26	bars	1	2	1	1.0	medium	6381
p26	bars	84	85	1	0.011904762	high	8197
p26	bars	46	40	6	0.13043478	medium	5206
p26	bars	55	60	5	0.09090909	high	5338
p26	bars	20	20	0	0.0	medium	4664
p26	bars	59	65	6	0.10169491	high	4816
p26	bars	29	30	1	0.03448276	high	3595
p26	bars	26	25	1	0.03846154	high	3171
p26	bars	73	75	2	0.02739726	medium	3427
p26	bars	53	60	7	0.13207547	medium	4402
p26	bars	26	30	4	0.15384616	medium	2911
p26	bars	13	15	2	0.15384616	high	3177
p26	bars	82	80	2	0.024390243	high	3216
p26	bars	40	40	0	0.0	medium	3877
p26	bars	61	65	4	0.06557377	medium	2337
p26	bars	45	45	0	0.0	medium	3195
p26	bars	53	55	2	0.03773585	medium	2396
p26	donut	53	55	2	0.03773585	high	5136
p26	donut	4	10	6	1.5	medium	5932
p26	donut	26	27	1	0.03846154	medium	10461
p26	donut	67	65	2	0.029850746	high	10385
p26	donut	1	1	0	0.0	high	2010
p26	donut	42	40	2	0.04761905	medium	4301
p26	donut	28	30	2	0.071428575	medium	4507
p26	donut	19	20	1	0.05263158	medium	2354
p26	donut	57	60	3	0.05263158	medium	2464
p26	donut	50	50	0	0.0	high	2165
p26	donut	71	70	1	0.014084507	high	2747
p26	donut	31	35	4	0.12903225	high	3100
p26	donut	43	40	3	0.069767445	medium	2464
p26	donut	23	25	2	0.08695652	medium	3026
p26	donut	52	53	1	0.01923077	medium	3762
p26	donut	75	75	0	0.0	high	3307
p26	donut	2	3	1	0.5	medium	2208
p26	donut	34	30	4	0.11764706	medium	2492
p26	donut	47	45	2	0.04255319	medium	3412
p26	donut	50	50	0	0.0	high	2071
p26	piechart	28	27	1	0.035714287	medium	7576
p26	piechart	34	35	1	0.029411765	medium	4258
p26	piechart	40	40	0	0.0	medium	2176
p26	piechart	24	22	2	0.083333336	medium	4312
p26	piechart	51	53	2	0.039215688	medium	2217
p26	piechart	65	70	5	0.07692308	medium	5261
p26	piechart	55	65	10	0.18181819	medium	2369
p26	piechart	50	50	0	0.0	high	3166
p26	piechart	71	70	1	0.014084507	high	2540
p26	piechart	65	65	0	0.0	medium	7121
p26	piechart	73	70	3	0.04109589	high	2490
p26	piechart	82	80	2	0.024390243	high	2417
p26	piechart	33	30	3	0.09090909	medium	5067
p26	piechart	29	28	1	0.03448276	medium	5355
p26	piechart	83	85	2	0.024096385	medium	4980
p26	piechart	41	40	1	0.024390243	medium	2705
p26	piechart	57	60	3	0.05263158	medium	2141
p26	piechart	40	40	0	0.0	medium	2490
p26	piechart	75	75	0	0.0	high	2513
p26	piechart	19	20	1	0.05263158	high	2758
p26	squarepie	40	30	10	0.25	medium	6608
p26	squarepie	33	24	9	0.27272728	high	5069
p26	squarepie	61	72	11	0.18032786	medium	19638
p26	squarepie	17	17	0	0.0	medium	4028
p26	squarepie	46	45	1	0.02173913	medium	4775
p26	squarepie	66	65	1	0.015151516	medium	3310
p26	squarepie	43	35	8	0.18604651	medium	2386
p26	squarepie	38	38	0	0.0	medium	4518
p26	squarepie	64	65	1	0.015625	medium	11863
p26	squarepie	35	35	0	0.0	medium	6429
p26	squarepie	59	58	1	0.016949153	medium	2814
p26	squarepie	40	40	0	0.0	high	3703
p26	squarepie	10	10	0	0.0	high	2110
p26	squarepie	67	68	1	0.014925373	medium	4227
p26	squarepie	65	65	0	0.0	medium	3770
p26	squarepie	20	20	0	0.0	high	2935
p26	squarepie	87	88	1	0.011494253	medium	5220
p26	squarepie	67	68	1	0.014925373	medium	4182
p26	squarepie	49	59	10	0.20408164	medium	4072
p26	squarepie	1	1	0	0.0	medium	4895
p27	donut	47	35	12	0.25531915	medium	17725
p27	donut	66	75	9	0.13636364	high	19422
p27	donut	61	60	1	0.016393442	high	21829
p27	donut	49	49	0	0.0	high	12423
p27	donut	41	40	1	0.024390243	high	10887
p27	donut	38	35	3	0.078947365	high	12239
p27	donut	99	98	1	0.01010101	high	8503
p27	donut	20	22	2	0.1	high	22582
p27	donut	43	47	4	0.093023255	high	9959
p27	donut	13	10	3	0.23076923	high	9071
p27	donut	59	55	4	0.06779661	high	7807
p27	donut	50	50	0	0.0	high	4543
p27	donut	60	57	3	0.05	high	4767
p27	donut	51	51	0	0.0	high	4095
p27	donut	99	98	1	0.01010101	high	5808
p27	donut	55	53	2	0.036363635	high	6311
p27	donut	6	5	1	0.16666667	high	10815
p27	donut	53	52	1	0.018867925	high	6983
p27	donut	25	25	0	0.0	high	4095
p27	donut	19	22	3	0.15789473	high	6831
p27	squarepie	64	64	0	0.0	high	10437
p27	squarepie	68	78	10	0.14705883	high	14871
p27	squarepie	43	45	2	0.046511628	high	16463
p27	squarepie	31	31	0	0.0	high	14135
p27	squarepie	44	33	11	0.25	high	7023
p27	squarepie	53	43	10	0.18867925	high	6015
p27	squarepie	29	29	0	0.0	high	19094
p27	squarepie	59	59	0	0.0	high	17503
p27	squarepie	42	42	0	0.0	high	3983
p27	squarepie	51	51	0	0.0	high	18519
p27	squarepie	87	87	0	0.0	high	43973
p27	squarepie	74	75	1	0.013513514	high	8399
p27	squarepie	47	46	1	0.021276595	high	19119
p27	squarepie	78	68	10	0.12820514	high	5335
p27	squarepie	93	94	1	0.010752688	high	7599
p27	squarepie	52	42	10	0.1923077	high	3912
p27	squarepie	86	85	1	0.011627907	high	9551
p27	squarepie	47	46	1	0.021276595	high	8719
p27	squarepie	65	55	10	0.15384616	high	4047
p27	squarepie	68	57	11	0.16176471	high	3735
p27	piechart	73	75	2	0.02739726	high	7477
p27	piechart	70	72	2	0.028571429	high	6847
p27	piechart	47	47	0	0.0	high	4256
p27	piechart	1	1	0	0.0	high	5687
p27	piechart	99	98	1	0.01010101	high	7407
p27	piechart	1	1	0	0.0	high	2576
p27	piechart	43	44	1	0.023255814	high	3231
p27	piechart	45	48	3	0.06666667	high	7119
p27	piechart	89	80	9	0.101123594	high	10039
p27	piechart	48	48	0	0.0	high	7415
p27	piechart	42	46	4	0.0952381	high	4360
p27	piechart	50	50	0	0.0	high	2742
p27	piechart	79	75	4	0.050632913	high	11183
p27	piechart	87	82	5	0.057471264	high	6520
p27	piechart	70	75	5	0.071428575	high	4575
p27	piechart	42	46	4	0.0952381	high	4023
p27	piechart	50	50	0	0.0	high	3087
p27	piechart	53	51	2	0.03773585	high	3936
p27	piechart	46	48	2	0.04347826	high	3815
p27	piechart	44	48	4	0.09090909	high	2975
p27	bars	61	55	6	0.09836066	high	2886
p27	bars	52	50	2	0.03846154	high	3135
p27	bars	99	99	0	0.0	high	5543
p27	bars	38	35	3	0.078947365	high	2911
p27	bars	65	65	0	0.0	high	3487
p27	bars	50	48	2	0.04	high	3576
p27	bars	68	58	10	0.14705883	high	3368
p27	bars	1	1	0	0.0	high	4455
p27	bars	99	98	1	0.01010101	high	7983
p27	bars	42	40	2	0.04761905	high	4120
p27	bars	1	2	1	1.0	high	3775
p27	bars	7	6	1	0.14285715	high	3103
p27	bars	73	87	14	0.19178082	high	3799
p27	bars	41	47	6	0.14634146	high	4632
p27	bars	74	80	6	0.08108108	high	4591
p27	bars	60	75	15	0.25	high	4935
p27	bars	64	77	13	0.203125	high	4391
p27	bars	48	65	17	0.35416666	high	2624
p27	bars	41	46	5	0.12195122	high	2775
p27	bars	54	53	1	0.018518519	high	4527
p28	bars	58	55	3	0.05172414	high	20390
p28	bars	52	61	9	0.17307693	high	7235
p28	bars	36	36	0	0.0	medium	10734
p28	bars	71	68	3	0.04225352	medium	7375
p28	bars	18	17	1	0.055555556	medium	13281
p28	bars	60	59	1	0.016666668	medium	9219
p28	bars	18	21	3	0.16666667	medium	7094
p28	bars	60	65	5	0.083333336	medium	11985
p28	bars	44	44	0	0.0	medium	4547
p28	bars	46	46	0	0.0	medium	6031
p28	bars	37	39	2	0.054054055	medium	5625
p28	bars	67	60	7	0.104477614	medium	5797
p28	bars	45	45	0	0.0	medium	8657
p28	bars	56	52	4	0.071428575	medium	7156
p28	bars	50	50	0	0.0	high	5625
p28	bars	59	53	6	0.10169491	medium	9453
p28	bars	68	68	0	0.0	medium	10203
p28	bars	38	38	0	0.0	medium	5265
p28	bars	41	40	1	0.024390243	medium	4844
p28	bars	45	41	4	0.08888889	medium	2984
p28	donut	76	77	1	0.013157895	medium	13750
p28	donut	56	55	1	0.017857144	medium	6516
p28	donut	96	96	0	0.0	medium	9485
p28	donut	35	32	3	0.08571429	medium	7656
p28	donut	38	30	8	0.21052632	medium	3797
p28	donut	92	80	12	0.13043478	medium	3765
p28	donut	24	23	1	0.041666668	medium	3672
p28	donut	79	78	1	0.012658228	medium	4422
p28	donut	96	96	0	0.0	medium	7156
p28	donut	56	57	1	0.017857144	medium	13797
p28	donut	76	76	0	0.0	medium	3907
p28	donut	64	70	6	0.09375	medium	8297
p28	donut	1	1	0	0.0	medium	2703
p28	donut	8	5	3	0.375	high	4422
p28	donut	13	9	4	0.30769232	medium	11078
p28	donut	52	52	0	0.0	medium	4266
p28	donut	15	16	1	0.06666667	medium	13328
p28	donut	60	58	2	0.033333335	medium	9812
p28	donut	69	66	3	0.04347826	medium	5235
p28	donut	27	28	1	0.037037037	medium	2672
p28	piechart	53	52	1	0.018867925	medium	4078
p28	piechart	57	56	1	0.01754386	medium	4062
p28	piechart	65	61	4	0.06153846	medium	4750
p28	piechart	48	48	0	0.0	medium	3703
p28	piechart	50	50	0	0.0	high	3750
p28	piechart	32	29	3	0.09375	medium	5969
p28	piechart	43	44	1	0.023255814	medium	7156
p28	piechart	3	2	1	0.33333334	medium	1812
p28	piechart	81	77	4	0.049382716	medium	5578
p28	piechart	25	25	0	0.0	high	2922
p28	piechart	89	81	8	0.08988764	medium	3813
p28	piechart	31	27	4	0.12903225	medium	3796
p28	piechart	73	72	1	0.01369863	high	6141
p28	piechart	51	51	0	0.0	high	3141
p28	piechart	54	54	0	0.0	medium	2937
p28	piechart	40	45	5	0.125	medium	7969
p28	piechart	72	72	0	0.0	medium	2844
p28	piechart	46	47	1	0.02173913	medium	6656
p28	piechart	37	33	4	0.10810811	high	4984
p28	piechart	69	70	1	0.014492754	medium	6953
p28	squarepie	42	42	0	0.0	high	6438
p28	squarepie	49	49	0	0.0	high	6109
p28	squarepie	24	24	0	0.0	high	4313
p28	squarepie	46	46	0	0.0	high	5015
p28	squarepie	40	40	0	0.0	high	2907
p28	squarepie	44	44	0	0.0	high	3640
p28	squarepie	46	46	0	0.0	high	4094
p28	squarepie	24	24	0	0.0	high	9469
p28	squarepie	16	16	0	0.0	high	2953
p28	squarepie	66	66	0	0.0	high	16797
p28	squarepie	34	34	0	0.0	high	4812
p28	squarepie	61	61	0	0.0	high	3938
p28	squarepie	79	79	0	0.0	high	5562
p28	squarepie	22	22	0	0.0	high	2532
p28	squarepie	77	77	0	0.0	high	4875
p28	squarepie	45	45	0	0.0	high	4703
p28	squarepie	56	56	0	0.0	high	6328
p28	squarepie	33	33	0	0.0	high	3797
p28	squarepie	41	41	0	0.0	high	2563
p28	squarepie	73	73	0	0.0	high	5828
p29	donut	27	26	1	0.037037037	high	12141
p29	donut	9	10	1	0.11111111	medium	5860
p29	donut	36	30	6	0.16666667	high	8297
p29	donut	76	76	0	0.0	high	7656
p29	donut	64	65	1	0.015625	high	5484
p29	donut	67	65	2	0.029850746	high	13156
p29	donut	3	5	2	0.6666667	high	3204
p29	donut	29	26	3	0.10344828	high	4078
p29	donut	70	73	3	0.042857144	high	4813
p29	donut	80	82	2	0.025	high	3688
p29	donut	22	20	2	0.09090909	high	3578
p29	donut	53	52	1	0.018867925	high	3718
p29	donut	14	13	1	0.071428575	high	3969
p29	donut	16	14	2	0.125	high	2250
p29	donut	71	72	1	0.014084507	high	5766
p29	donut	62	61	1	0.016129032	high	6578
p29	donut	4	5	1	0.25	high	2094
p29	donut	1	2	1	1.0	high	1734
p29	donut	99	98	1	0.01010101	high	5000
p29	donut	52	51	1	0.01923077	high	3922
p29	piechart	26	26	0	0.0	high	7656
p29	piechart	69	73	4	0.057971016	high	21266
p29	piechart	99	99	0	0.0	high	3734
p29	piechart	45	45	0	0.0	high	12235
p29	piechart	62	60	2	0.032258064	high	2968
p29	piechart	6	5	1	0.16666667	high	2063
p29	piechart	75	75	0	0.0	high	2281
p29	piechart	46	45	1	0.02173913	high	4969
p29	piechart	12	10	2	0.16666667	high	4000
p29	piechart	80	80	0	0.0	high	2828
p29	piechart	59	60	1	0.016949153	high	3359
p29	piechart	65	65	0	0.0	high	2219
p29	piechart	84	80	4	0.04761905	high	2719
p29	piechart	46	45	1	0.02173913	high	3359
p29	piechart	62	55	7	0.11290322	high	2563
p29	piechart	42	45	3	0.071428575	high	1953
p29	piechart	5	10	5	1.0	high	3312
p29	piechart	41	40	1	0.024390243	high	3907
p29	piechart	61	60	1	0.016393442	high	3875
p29	piechart	40	40	0	0.0	high	1843
p29	squarepie	98	90	8	0.08163265	high	6828
p29	squarepie	37	38	1	0.027027028	medium	15609
p29	squarepie	41	41	0	0.0	medium	4297
p29	squarepie	55	53	2	0.036363635	medium	4094
p29	squarepie	27	25	2	0.074074075	medium	2265
p29	squarepie	1	10	9	9.0	medium	2610
p29	squarepie	21	21	0	0.0	medium	3265
p29	squarepie	24	23	1	0.041666668	medium	1844
p29	squarepie	68	75	7	0.10294118	medium	2703
p29	squarepie	26	21	5	0.1923077	medium	5938
p29	squarepie	69	80	11	0.1594203	medium	3781
p29	squarepie	78	85	7	0.08974359	medium	1968
p29	squarepie	18	20	2	0.11111111	medium	3547
p29	squarepie	63	55	8	0.12698413	medium	3297
p29	squarepie	1	10	9	9.0	medium	3391
p29	squarepie	44	45	1	0.022727273	medium	2203
p29	squarepie	42	41	1	0.023809524	medium	2110
p29	squarepie	38	42	4	0.10526316	medium	1828
p29	squarepie	43	45	2	0.046511628	medium	2218
p29	squarepie	26	30	4	0.15384616	medium	3250
p29	bars	49	50	1	0.020408163	high	4297
p29	bars	40	40	0	0.0	high	2000
p29	bars	12	20	8	0.6666667	high	3656
p29	bars	1	2	1	1.0	high	3703
p29	bars	56	65	9	0.16071428	high	2454
p29	bars	17	15	2	0.11764706	high	1734
p29	bars	41	42	1	0.024390243	high	6094
p29	bars	58	62	4	0.06896552	high	3547
p29	bars	51	50	1	0.019607844	high	1828
p29	bars	30	30	0	0.0	high	2032
p29	bars	52	50	2	0.03846154	high	2734
p29	bars	56	60	4	0.071428575	high	2594
p29	bars	45	45	0	0.0	high	2328
p29	bars	58	52	6	0.10344828	high	2422
p29	bars	77	80	3	0.038961038	high	4281
p29	bars	31	35	4	0.12903225	high	4516
p29	bars	45	40	5	0.11111111	high	2375
p29	bars	50	50	0	0.0	high	2671
p29	bars	22	20	2	0.09090909	high	1954
p29	bars	46	40	6	0.13043478	high	4656
p30	donut	45	33	12	0.26666668	high	19703
p30	donut	17	17	0	0.0	high	24578
p30	donut	45	45	0	0.0	high	6313
p30	donut	69	68	1	0.014492754	medium	12516
p30	donut	66	63	3	0.045454547	medium	13390
p30	donut	11	10	1	0.09090909	medium	8516
p30	donut	46	45	1	0.02173913	high	7062
p30	donut	1	2	1	1.0	medium	19906
p30	donut	58	56	2	0.03448276	high	6281
p30	donut	86	84	2	0.023255814	high	11250
p30	donut	25	25	0	0.0	high	4422
p30	donut	49	49	0	0.0	high	9250
p30	donut	1	1	0	0.0	high	7063
p30	donut	38	38	0	0.0	high	11062
p30	donut	69	65	4	0.057971016	high	13875
p30	donut	37	34	3	0.08108108	high	7188
p30	donut	47	46	1	0.021276595	high	8047
p30	donut	68	67	1	0.014705882	high	7625
p30	donut	90	90	0	0.0	high	5453
p30	donut	55	55	0	0.0	high	5437
p30	squarepie	57	58	1	0.01754386	medium	14969
p30	squarepie	31	27	4	0.12903225	medium	7422
p30	squarepie	54	54	0	0.0	high	4250
p30	squarepie	45	44	1	0.022222223	high	5312
p30	squarepie	54	53	1	0.018518519	high	6031
p30	squarepie	79	79	0	0.0	high	11985
p30	squarepie	38	38	0	0.0	high	8469
p30	squarepie	62	63	1	0.016129032	medium	5093
p30	squarepie	78	78	0	0.0	high	12125
p30	squarepie	29	29	0	0.0	high	4594
p30	squarepie	1	1	0	0.0	high	3063
p30	squarepie	68	68	0	0.0	high	8593
p30	squarepie	48	48	0	0.0	high	5860
p30	squarepie	78	78	0	0.0	high	8156
p30	squarepie	56	56	0	0.0	high	10922
p30	squarepie	62	62	0	0.0	high	6015
p30	squarepie	47	47	0	0.0	high	4250
p30	squarepie	40	40	0	0.0	high	2891
p30	squarepie	18	18	0	0.0	high	5578
p30	squarepie	53	53	0	0.0	high	3516
p30	piechart	22	22	0	0.0	high	16578
p30	piechart	71	71	0	0.0	high	6500
p30	piechart	15	13	2	0.13333334	high	8516
p30	piechart	67	65	2	0.029850746	high	7531
p30	piechart	20	22	2	0.1	high	4110
p30	piechart	90	90	0	0.0	high	7390
p30	piechart	70	69	1	0.014285714	high	5703
p30	piechart	41	43	2	0.048780486	high	12532
p30	piechart	71	70	1	0.014084507	high	9796
p30	piechart	35	35	0	0.0	high	7782
p30	piechart	44	44	0	0.0	high	11203
p30	piechart	61	60	1	0.016393442	high	7890
p30	piechart	88	88	0	0.0	high	9766
p30	piechart	55	55	0	0.0	high	6609
p30	piechart	34	31	3	0.0882353	high	6938
p30	piechart	5	4	1	0.2	high	10062
p30	piechart	36	35	1	0.027777778	high	13782
p30	piechart	99	98	1	0.01010101	high	10562
p30	piechart	68	69	1	0.014705882	high	7328
p30	piechart	39	38	1	0.025641026	high	11141
p30	bars	36	40	4	0.11111111	high	9125
p30	bars	60	60	0	0.0	high	20843
p30	bars	31	32	1	0.032258064	high	8172
p30	bars	54	55	1	0.018518519	high	4532
p30	bars	29	30	1	0.03448276	high	9984
p30	bars	23	25	2	0.08695652	high	5797
p30	bars	52	52	0	0.0	high	5047
p30	bars	44	45	1	0.022727273	high	3765
p30	bars	55	53	2	0.036363635	high	4953
p30	bars	65	61	4	0.06153846	high	3688
p30	bars	71	67	4	0.056338027	high	7578
p30	bars	59	55	4	0.06779661	high	4391
p30	bars	17	14	3	0.1764706	high	9843
p30	bars	51	50	1	0.019607844	high	4797
p30	bars	67	62	5	0.07462686	high	6203
p30	bars	27	25	2	0.074074075	high	3141
p30	bars	91	89	2	0.021978023	high	16953
p30	bars	97	96	1	0.010309278	high	4328
p30	bars	82	82	0	0.0	high	12609
p30	bars	29	30	1	0.03448276	high	5938
p31	squarepie	58	58	0	0.0	high	77937
p31	squarepie	68	68	0	0.0	high	61860
p31	squarepie	73	73	0	0.0	high	14421
p31	squarepie	39	39	0	0.0	high	15500
p31	squarepie	77	77	0	0.0	high	15204
p31	squarepie	17	17	0	0.0	high	19484
p31	squarepie	52	52	0	0.0	high	16172
p31	squarepie	68	68	0	0.0	high	19140
p31	squarepie	44	44	0	0.0	high	15672
p31	squarepie	59	59	0	0.0	high	8875
p31	squarepie	19	19	0	0.0	high	5813
p31	squarepie	15	15	0	0.0	high	9765
p31	squarepie	32	32	0	0.0	high	11329
p31	squarepie	79	79	0	0.0	high	7562
p31	squarepie	52	52	0	0.0	high	8000
p31	squarepie	69	69	0	0.0	high	7156
p31	squarepie	45	45	0	0.0	high	13219
p31	squarepie	1	1	0	0.0	high	3531
p31	squarepie	29	29	0	0.0	high	5266
p31	squarepie	45	45	0	0.0	high	12062
p31	bars	28	28	0	0.0	medium	49391
p31	bars	53	52	1	0.018867925	medium	41843
p31	bars	65	64	1	0.015384615	medium	11344
p31	bars	54	54	0	0.0	medium	17922
p31	bars	14	13	1	0.071428575	medium	11891
p31	bars	49	48	1	0.020408163	medium	34906
p31	bars	55	55	0	0.0	medium	5547
p31	bars	35	35	0	0.0	medium	7437
p31	bars	66	66	0	0.0	high	7485
p31	bars	23	23	0	0.0	high	5250
p31	bars	50	50	0	0.0	high	3531
p31	bars	75	75	0	0.0	medium	6687
p31	bars	27	27	0	0.0	medium	5375
p31	bars	39	38	1	0.025641026	medium	7469
p31	bars	23	23	0	0.0	high	3578
p31	bars	33	32	1	0.030303031	high	3219
p31	bars	98	98	0	0.0	high	22562
p31	bars	60	60	0	0.0	medium	3688
p31	bars	40	39	1	0.025	high	5062
p31	bars	17	15	2	0.11764706	high	4141
p31	donut	63	66	3	0.04761905	medium	197453
p31	donut	82	83	1	0.0121951215	medium	15094
p31	donut	70	74	4	0.057142857	medium	17172
p31	donut	12	10	2	0.16666667	medium	11546
p31	donut	54	56	2	0.037037037	medium	6844
p31	donut	12	10	2	0.16666667	medium	11719
p31	donut	80	82	2	0.025	medium	13797
p31	donut	62	65	3	0.048387095	medium	5797
p31	donut	50	50	0	0.0	high	15375
p31	donut	99	99	0	0.0	high	8250
p31	donut	40	40	0	0.0	medium	10953
p31	donut	49	48	1	0.020408163	medium	7594
p31	donut	1	1	0	0.0	medium	4531
p31	donut	33	38	5	0.15151516	medium	4562
p31	donut	44	42	2	0.045454547	medium	7891
p31	donut	23	24	1	0.04347826	medium	4078
p31	donut	1	1	0	0.0	high	4656
p31	donut	76	77	1	0.013157895	medium	11407
p31	donut	47	45	2	0.04255319	medium	7828
p31	donut	28	28	0	0.0	medium	5734
p31	piechart	54	55	1	0.018518519	medium	55625
p31	piechart	18	17	1	0.055555556	medium	11125
p31	piechart	38	42	4	0.10526316	medium	6235
p31	piechart	1	1	0	0.0	high	3062
p31	piechart	96	95	1	0.010416667	medium	5922
p31	piechart	76	77	1	0.013157895	medium	7656
p31	piechart	42	40	2	0.04761905	medium	12016
p31	piechart	47	46	1	0.021276595	medium	4906
p31	piechart	41	44	3	0.07317073	medium	6750
p31	piechart	26	27	1	0.03846154	medium	6234
p31	piechart	47	47	0	0.0	medium	5219
p31	piechart	80	87	7	0.0875	medium	8187
p31	piechart	15	13	2	0.13333334	medium	5797
p31	piechart	1	1	0	0.0	high	3453
p31	piechart	58	58	0	0.0	medium	9984
p31	piechart	81	88	7	0.086419754	medium	7907
p31	piechart	35	34	1	0.028571429	medium	8375
p31	piechart	23	22	1	0.04347826	medium	5218
p31	piechart	56	56	0	0.0	medium	6047
p31	piechart	36	33	3	0.083333336	medium	13203
p32	donut	56	55	1	0.017857144	high	24563
p32	donut	73	60	13	0.1780822	high	12575
p32	donut	51	50	1	0.019607844	high	19032
p32	donut	1	1	0	0.0	medium	14816
p32	donut	71	60	11	0.15492958	high	9930
p32	donut	63	55	8	0.12698413	medium	8397
p32	donut	42	45	3	0.071428575	medium	7383
p32	donut	60	53	7	0.11666667	medium	5192
p32	donut	51	50	1	0.019607844	high	3425
p32	donut	79	72	7	0.088607594	medium	9574
p32	donut	47	48	1	0.021276595	medium	6168
p32	donut	23	23	0	0.0	medium	10262
p32	donut	26	25	1	0.03846154	high	3345
p32	donut	47	47	0	0.0	medium	5358
p32	donut	44	45	1	0.022727273	medium	4791
p32	donut	74	75	1	0.013513514	high	4976
p32	donut	39	33	6	0.15384616	medium	6032
p32	donut	61	52	9	0.14754099	medium	7567
p32	donut	86	85	1	0.011627907	medium	15944
p32	donut	68	73	5	0.073529415	medium	6599
p32	piechart	41	46	5	0.12195122	medium	30957
p32	piechart	67	60	7	0.104477614	medium	8589
p32	piechart	57	55	2	0.03508772	medium	3120
p32	piechart	32	35	3	0.09375	medium	4368
p32	piechart	57	53	4	0.07017544	medium	3374
p32	piechart	69	69	0	0.0	medium	11808
p32	piechart	74	74	0	0.0	medium	8184
p32	piechart	13	12	1	0.07692308	medium	12488
p32	piechart	1	1	0	0.0	medium	3207
p32	piechart	69	72	3	0.04347826	medium	6920
p32	piechart	73	73	0	0.0	medium	3327
p32	piechart	63	60	3	0.04761905	medium	6578
p32	piechart	83	80	3	0.036144577	medium	6341
p32	piechart	41	40	1	0.024390243	medium	9919
p32	piechart	63	55	8	0.12698413	medium	4160
p32	piechart	99	99	0	0.0	medium	6703
p32	piechart	69	70	1	0.014492754	medium	6777
p32	piechart	36	30	6	0.16666667	medium	8174
p32	piechart	95	90	5	0.05263158	medium	6592
p32	piechart	90	85	5	0.055555556	medium	8200
p32	squarepie	58	58	0	0.0	medium	12922
p32	squarepie	76	75	1	0.013157895	medium	6992
p32	squarepie	74	73	1	0.013513514	medium	11652
p32	squarepie	79	79	0	0.0	medium	6440
p32	squarepie	77	77	0	0.0	medium	3536
p32	squarepie	61	61	0	0.0	medium	7992
p32	squarepie	64	63	1	0.015625	medium	4558
p32	squarepie	28	28	0	0.0	medium	5800
p32	squarepie	36	34	2	0.055555556	medium	4384
p32	squarepie	55	55	0	0.0	medium	12312
p32	squarepie	58	58	0	0.0	medium	5708
p32	squarepie	15	15	0	0.0	medium	4696
p32	squarepie	64	63	1	0.015625	medium	5552
p32	squarepie	13	13	0	0.0	medium	3503
p32	squarepie	48	48	0	0.0	medium	4728
p32	squarepie	40	40	0	0.0	medium	7583
p32	squarepie	58	58	0	0.0	medium	6808
p32	squarepie	18	18	0	0.0	medium	5097
p32	squarepie	74	73	1	0.013513514	medium	7246
p32	squarepie	24	23	1	0.041666668	medium	3920
p32	bars	13	15	2	0.15384616	medium	11258
p32	bars	38	45	7	0.18421052	medium	13216
p32	bars	70	60	10	0.14285715	medium	3776
p32	bars	31	40	9	0.29032257	medium	3512
p32	bars	67	60	7	0.104477614	medium	4832
p32	bars	95	95	0	0.0	medium	9680
p32	bars	99	99	0	0.0	medium	4913
p32	bars	87	90	3	0.03448276	medium	4071
p32	bars	25	30	5	0.2	medium	5000
p32	bars	45	45	0	0.0	medium	3279
p32	bars	57	55	2	0.03508772	medium	6472
p32	bars	69	60	9	0.13043478	medium	3736
p32	bars	73	65	8	0.10958904	medium	4799
p32	bars	35	40	5	0.14285715	medium	7127
p32	bars	58	52	6	0.10344828	medium	5943
p32	bars	32	35	3	0.09375	medium	9871
p32	bars	34	40	6	0.1764706	medium	2464
p32	bars	1	1	0	0.0	medium	4606
p32	bars	75	70	5	0.06666667	medium	10968
p32	bars	73	65	8	0.10958904	medium	3008
p33	piechart	23	35	12	0.5217391	high	16297
p33	piechart	27	28	1	0.037037037	high	26281
p33	piechart	1	5	4	4.0	high	9906
p33	piechart	41	45	4	0.09756097	high	6344
p33	piechart	47	48	1	0.021276595	high	11875
p33	piechart	22	20	2	0.09090909	high	8641
p33	piechart	72	70	2	0.027777778	high	11156
p33	piechart	5	10	5	1.0	high	6015
p33	piechart	53	54	1	0.018867925	high	9110
p33	piechart	45	46	1	0.022222223	high	8047
p33	piechart	99	98	1	0.01010101	high	8515
p33	piechart	71	72	1	0.014084507	high	10516
p33	piechart	30	30	0	0.0	high	6094
p33	piechart	60	60	0	0.0	high	5218
p33	piechart	23	22	1	0.04347826	high	7969
p33	piechart	28	28	0	0.0	high	7828
p33	piechart	69	67	2	0.028985508	high	16453
p33	piechart	28	28	0	0.0	high	13547
p33	piechart	54	59	5	0.09259259	high	6672
p33	piechart	88	87	1	0.011363637	high	9266
p33	donut	58	55	3	0.05172414	high	7688
p33	donut	86	81	5	0.058139537	high	10203
p33	donut	74	74	0	0.0	high	5312
p33	donut	38	37	1	0.02631579	high	8735
p33	donut	31	30	1	0.032258064	high	6672
p33	donut	91	86	5	0.054945055	high	10422
p33	donut	43	45	2	0.046511628	high	7984
p33	donut	58	55	3	0.05172414	high	3579
p33	donut	41	43	2	0.048780486	medium	11687
p33	donut	29	27	2	0.06896552	high	6672
p33	donut	57	56	1	0.01754386	high	10437
p33	donut	68	72	4	0.05882353	medium	8157
p33	donut	64	70	6	0.09375	medium	4797
p33	donut	22	20	2	0.09090909	high	6531
p33	donut	67	69	2	0.029850746	medium	16750
p33	donut	50	50	0	0.0	high	7031
p33	donut	62	64	2	0.032258064	medium	13625
p33	donut	12	15	3	0.25	high	5297
p33	donut	36	35	1	0.027777778	medium	12281
p33	donut	42	45	3	0.071428575	high	5328
p33	bars	10	10	0	0.0	medium	9796
p33	bars	99	97	2	0.02020202	high	6313
p33	bars	78	85	7	0.08974359	medium	7516
p33	bars	57	62	5	0.0877193	medium	6938
p33	bars	63	70	7	0.11111111	medium	3609
p33	bars	24	25	1	0.041666668	medium	3969
p33	bars	15	15	0	0.0	medium	3625
p33	bars	34	35	1	0.029411765	medium	3953
p33	bars	36	40	4	0.11111111	medium	3344
p33	bars	62	59	3	0.048387095	medium	6172
p33	bars	21	25	4	0.1904762	medium	9593
p33	bars	68	75	7	0.10294118	medium	6516
p33	bars	48	47	1	0.020833334	medium	5672
p33	bars	16	15	1	0.0625	medium	2953
p33	bars	29	37	8	0.27586207	medium	4578
p33	bars	57	60	3	0.05263158	medium	5297
p33	bars	70	75	5	0.071428575	medium	3984
p33	bars	64	70	6	0.09375	medium	3110
p33	bars	34	40	6	0.1764706	medium	6390
p33	bars	72	75	3	0.041666668	medium	3797
p33	squarepie	44	50	6	0.13636364	medium	7797
p33	squarepie	76	75	1	0.013157895	medium	7750
p33	squarepie	66	68	2	0.030303031	medium	4359
p33	squarepie	74	70	4	0.054054055	medium	7016
p33	squarepie	72	69	3	0.041666668	medium	6594
p33	squarepie	19	15	4	0.21052632	medium	6093
p33	squarepie	15	13	2	0.13333334	medium	4688
p33	squarepie	83	90	7	0.084337346	medium	6344
p33	squarepie	30	25	5	0.16666667	medium	8875
p33	squarepie	1	5	4	4.0	medium	3843
p33	squarepie	36	36	0	0.0	medium	31922
p33	squarepie	99	99	0	0.0	high	7578
p33	squarepie	18	18	0	0.0	medium	11656
p33	squarepie	31	31	0	0.0	medium	6969
p33	squarepie	85	85	0	0.0	medium	18422
p33	squarepie	11	11	0	0.0	medium	3562
p33	squarepie	74	64	10	0.13513513	medium	11688
p33	squarepie	59	59	0	0.0	medium	8750
p33	squarepie	44	44	0	0.0	medium	9594
p33	squarepie	81	81	0	0.0	medium	13312
p34	bars	49	47	2	0.040816326	high	26453
p34	bars	39	38	1	0.025641026	high	16517
p34	bars	36	36	0	0.0	high	18551
p34	bars	57	57	0	0.0	high	15311
p34	bars	26	27	1	0.03846154	high	16734
p34	bars	62	64	2	0.032258064	high	17071
p34	bars	67	68	1	0.014925373	high	7511
p34	bars	33	35	2	0.060606062	high	9255
p34	bars	37	38	1	0.027027028	medium	25959
p34	bars	60	59	1	0.016666668	high	14527
p34	bars	65	65	0	0.0	high	15711
p34	bars	1	2	1	1.0	high	17900
p34	bars	9	10	1	0.11111111	high	11614
p34	bars	47	48	1	0.021276595	high	10599
p34	bars	1	2	1	1.0	high	10663
p34	bars	41	39	2	0.048780486	medium	15335
p34	bars	81	82	1	0.012345679	high	40431
p34	bars	78	80	2	0.025641026	medium	8759
p34	bars	81	83	2	0.024691358	high	8847
p34	bars	43	43	0	0.0	high	10519
p34	donut	57	58	1	0.01754386	high	30524
p34	donut	1	1	0	0.0	high	6311
p34	donut	54	54	0	0.0	high	10359
p34	donut	70	71	1	0.014285714	high	15647
p34	donut	22	13	9	0.4090909	high	18759
p34	donut	61	58	3	0.04918033	high	16919
p34	donut	48	48	0	0.0	high	8487
p34	donut	63	59	4	0.06349207	high	11895
p34	donut	83	15	68	0.8192771	medium	36652
p34	donut	95	95	0	0.0	high	13623
p34	donut	92	93	1	0.010869565	high	9415
p34	donut	47	48	1	0.021276595	high	6879
p34	donut	42	44	2	0.04761905	high	6719
p34	donut	71	70	1	0.014084507	high	16359
p34	donut	86	85	1	0.011627907	high	9878
p34	donut	34	34	0	0.0	high	13191
p34	donut	71	71	0	0.0	high	9527
p34	donut	20	18	2	0.1	medium	15127
p34	donut	40	40	0	0.0	high	6751
p34	donut	58	54	4	0.06896552	medium	16503
p34	piechart	12	12	0	0.0	high	27623
p34	piechart	46	46	0	0.0	high	13096
p34	piechart	40	43	3	0.075	high	7919
p34	piechart	28	29	1	0.035714287	high	13736
p34	piechart	53	53	0	0.0	high	11406
p34	piechart	69	66	3	0.04347826	high	13320
p34	piechart	62	62	0	0.0	high	15288
p34	piechart	41	40	1	0.024390243	high	20392
p34	piechart	55	56	1	0.018181818	high	5112
p34	piechart	63	63	0	0.0	high	12688
p34	piechart	66	65	1	0.015151516	high	7448
p34	piechart	29	31	2	0.06896552	high	6255
p34	piechart	5	5	0	0.0	high	11057
p34	piechart	62	60	2	0.032258064	high	15951
p34	piechart	53	53	0	0.0	high	10400
p34	piechart	76	76	0	0.0	high	5992
p34	piechart	67	69	2	0.029850746	high	8112
p34	piechart	39	40	1	0.025641026	high	7904
p34	piechart	8	8	0	0.0	high	6240
p34	piechart	27	27	0	0.0	high	10368
p34	squarepie	16	16	0	0.0	high	12165
p34	squarepie	87	87	0	0.0	high	5351
p34	squarepie	74	74	0	0.0	high	6271
p34	squarepie	37	37	0	0.0	high	7656
p34	squarepie	52	52	0	0.0	medium	10920
p34	squarepie	63	63	0	0.0	high	4824
p34	squarepie	51	51	0	0.0	high	11176
p34	squarepie	56	56	0	0.0	high	2496
p34	squarepie	69	69	0	0.0	high	3392
p34	squarepie	44	44	0	0.0	high	3184
p34	squarepie	40	40	0	0.0	high	2448
p34	squarepie	37	37	0	0.0	high	2840
p34	squarepie	53	53	0	0.0	high	5256
p34	squarepie	24	24	0	0.0	high	4543
p34	squarepie	10	10	0	0.0	high	2472
p34	squarepie	99	99	0	0.0	high	2616
p34	squarepie	72	72	0	0.0	high	3776
p34	squarepie	60	60	0	0.0	high	4176
p34	squarepie	68	68	0	0.0	high	5888
p34	squarepie	55	55	0	0.0	high	3263
p35	piechart	51	52	1	0.019607844	high	52746
p35	piechart	36	31	5	0.1388889	high	26859
p35	piechart	97	95	2	0.020618556	high	28130
p35	piechart	49	48	1	0.020408163	high	10165
p35	piechart	40	33	7	0.175	high	12348
p35	piechart	56	60	4	0.071428575	medium	16143
p35	piechart	32	30	2	0.0625	medium	7531
p35	piechart	65	67	2	0.03076923	high	8312
p35	piechart	55	58	3	0.054545455	medium	8382
p35	piechart	67	70	3	0.04477612	high	16474
p35	piechart	43	38	5	0.11627907	medium	11536
p35	piechart	79	79	0	0.0	high	11877
p35	piechart	32	30	2	0.0625	medium	7691
p35	piechart	73	72	1	0.01369863	high	11266
p35	piechart	24	23	1	0.041666668	high	14091
p35	piechart	68	70	2	0.029411765	medium	10485
p35	piechart	93	86	7	0.07526882	medium	13139
p35	piechart	46	44	2	0.04347826	high	7531
p35	piechart	60	62	2	0.033333335	high	8942
p35	piechart	79	79	0	0.0	high	12518
p35	donut	18	15	3	0.16666667	high	16564
p35	donut	71	70	1	0.014084507	high	5878
p35	donut	99	97	2	0.02020202	high	10165
p35	donut	68	70	2	0.029411765	medium	6730
p35	donut	56	56	0	0.0	medium	7400
p35	donut	78	79	1	0.012820513	high	8162
p35	donut	60	63	3	0.05	high	14391
p35	donut	99	97	2	0.02020202	high	4867
p35	donut	67	66	1	0.014925373	high	4737
p35	donut	70	70	0	0.0	medium	14160
p35	donut	46	45	1	0.02173913	high	8612
p35	donut	36	33	3	0.083333336	high	6920
p35	donut	47	45	2	0.04255319	high	6069
p35	donut	65	68	3	0.046153847	high	7561
p35	donut	10	10	0	0.0	medium	6519
p35	donut	34	31	3	0.0882353	medium	8272
p35	donut	18	16	2	0.11111111	medium	12338
p35	donut	1	3	2	2.0	high	8132
p35	donut	87	87	0	0.0	medium	13850
p35	donut	29	28	1	0.03448276	high	9654
p35	squarepie	83	80	3	0.036144577	low	16523
p35	squarepie	53	53	0	0.0	medium	14571
p35	squarepie	59	57	2	0.033898305	medium	7551
p35	squarepie	77	77	0	0.0	medium	6339
p35	squarepie	31	23	8	0.2580645	medium	10145
p35	squarepie	63	66	3	0.04761905	medium	6399
p35	squarepie	18	28	10	0.5555556	medium	9634
p35	squarepie	55	55	0	0.0	medium	5338
p35	squarepie	99	97	2	0.02020202	medium	7420
p35	squarepie	63	65	2	0.031746034	medium	8372
p35	squarepie	19	18	1	0.05263158	medium	6470
p35	squarepie	51	53	2	0.039215688	medium	4807
p35	squarepie	77	78	1	0.012987013	medium	8792
p35	squarepie	67	67	0	0.0	medium	8542
p35	squarepie	10	11	1	0.1	high	6500
p35	squarepie	50	50	0	0.0	high	4636
p35	squarepie	17	17	0	0.0	medium	7421
p35	squarepie	62	63	1	0.016129032	medium	5558
p35	squarepie	53	52	1	0.018867925	medium	6439
p35	squarepie	98	95	3	0.030612245	medium	9804
p35	bars	46	50	4	0.08695652	high	4747
p35	bars	54	58	4	0.074074075	medium	6589
p35	bars	99	98	1	0.01010101	high	6139
p35	bars	49	49	0	0.0	medium	6649
p35	bars	46	45	1	0.02173913	medium	3375
p35	bars	33	33	0	0.0	medium	4176
p35	bars	35	36	1	0.028571429	medium	5138
p35	bars	66	60	6	0.09090909	medium	3995
p35	bars	79	75	4	0.050632913	medium	4988
p35	bars	34	40	6	0.1764706	medium	5077
p35	bars	31	34	3	0.09677419	medium	8753
p35	bars	72	74	2	0.027777778	medium	8862
p35	bars	1	3	2	2.0	medium	7050
p35	bars	33	33	0	0.0	medium	3836
p35	bars	81	77	4	0.049382716	medium	5818
p35	bars	31	30	1	0.032258064	medium	12789
p35	bars	35	33	2	0.057142857	medium	3515
p35	bars	77	75	2	0.025974026	medium	6159
p35	bars	18	20	2	0.11111111	medium	5628
p35	bars	30	27	3	0.1	medium	8452
p36	squarepie	40	48	8	0.2	high	27219
p36	squarepie	17	18	1	0.05882353	high	20328
p36	squarepie	82	82	0	0.0	high	16797
p36	squarepie	47	48	1	0.021276595	high	10985
p36	squarepie	49	49	0	0.0	high	7641
p36	squarepie	79	89	10	0.12658228	high	9515
p36	squarepie	41	41	0	0.0	high	11125
p36	squarepie	29	29	0	0.0	high	9563
p36	squarepie	62	62	0	0.0	high	6422
p36	squarepie	35	35	0	0.0	high	6109
p36	squarepie	48	38	10	0.20833333	high	19500
p36	squarepie	76	76	0	0.0	high	8985
p36	squarepie	55	45	10	0.18181819	high	16046
p36	squarepie	82	82	0	0.0	high	11079
p36	squarepie	1	1	0	0.0	high	9875
p36	squarepie	37	37	0	0.0	high	7515
p36	squarepie	32	32	0	0.0	high	4438
p36	squarepie	45	45	0	0.0	high	4890
p36	squarepie	19	19	0	0.0	high	8328
p36	squarepie	31	31	0	0.0	high	8391
p36	piechart	44	40	4	0.09090909	medium	12250
p36	piechart	18	20	2	0.11111111	medium	7265
p36	piechart	81	80	1	0.012345679	medium	5344
p36	piechart	56	70	14	0.25	medium	4719
p36	piechart	74	73	1	0.013513514	medium	17969
p36	piechart	81	78	3	0.037037037	medium	11328
p36	piechart	69	70	1	0.014492754	medium	21031
p36	piechart	17	18	1	0.05882353	medium	17953
p36	piechart	41	38	3	0.07317073	medium	13828
p36	piechart	29	28	1	0.03448276	medium	14047
p36	piechart	11	15	4	0.36363637	medium	6297
p36	piechart	31	28	3	0.09677419	medium	9687
p36	piechart	60	60	0	0.0	medium	10282
p36	piechart	25	25	0	0.0	high	5672
p36	piechart	76	75	1	0.013157895	high	4687
p36	piechart	39	30	9	0.23076923	medium	8750
p36	piechart	75	75	0	0.0	high	5016
p36	piechart	78	78	0	0.0	high	6984
p36	piechart	96	92	4	0.041666668	medium	13344
p36	piechart	63	65	2	0.031746034	medium	9719
p36	donut	46	45	1	0.02173913	medium	10250
p36	donut	68	70	2	0.029411765	medium	6922
p36	donut	51	52	1	0.019607844	high	11656
p36	donut	58	60	2	0.03448276	medium	5719
p36	donut	72	70	2	0.027777778	medium	6406
p36	donut	51	51	0	0.0	medium	5562
p36	donut	66	65	1	0.015151516	medium	9469
p36	donut	43	45	2	0.046511628	medium	6344
p36	donut	59	60	1	0.016949153	medium	6984
p36	donut	83	80	3	0.036144577	medium	4610
p36	donut	15	20	5	0.33333334	medium	6875
p36	donut	44	45	1	0.022727273	medium	7984
p36	donut	53	52	1	0.018867925	medium	5750
p36	donut	48	48	0	0.0	medium	5547
p36	donut	50	50	0	0.0	high	5969
p36	donut	53	52	1	0.018867925	medium	4203
p36	donut	58	60	2	0.03448276	medium	3359
p36	donut	72	70	2	0.027777778	medium	4500
p36	donut	59	62	3	0.050847456	medium	9813
p36	donut	30	28	2	0.06666667	medium	6687
p36	bars	1	1	0	0.0	medium	6015
p36	bars	37	40	3	0.08108108	medium	7125
p36	bars	50	50	0	0.0	medium	3672
p36	bars	72	70	2	0.027777778	medium	4203
p36	bars	93	90	3	0.032258064	medium	3922
p36	bars	60	55	5	0.083333336	medium	3235
p36	bars	26	30	4	0.15384616	medium	3750
p36	bars	70	65	5	0.071428575	medium	6484
p36	bars	82	75	7	0.085365854	medium	4297
p36	bars	99	99	0	0.0	medium	3687
p36	bars	66	60	6	0.09090909	medium	4829
p36	bars	61	60	1	0.016393442	medium	5718
p36	bars	35	40	5	0.14285715	medium	4578
p36	bars	87	80	7	0.08045977	medium	4797
p36	bars	29	30	1	0.03448276	medium	3266
p36	bars	82	70	12	0.14634146	medium	7625
p36	bars	69	65	4	0.057971016	medium	3781
p36	bars	62	55	7	0.11290322	medium	11078
p36	bars	35	35	0	0.0	medium	7438
p36	bars	50	50	0	0.0	high	8375
p37	bars	54	50	4	0.074074075	medium	8641
p37	bars	39	32	7	0.17948718	medium	6188
p37	bars	37	30	7	0.1891892	high	5718
p37	bars	43	37	6	0.13953489	medium	3078
p37	bars	58	58	0	0.0	medium	5969
p37	bars	47	42	5	0.10638298	medium	6140
p37	bars	42	36	6	0.14285715	medium	4516
p37	bars	16	16	0	0.0	medium	4500
p37	bars	70	68	2	0.028571429	medium	4547
p37	bars	75	76	1	0.013333334	medium	5515
p37	bars	7	12	5	0.71428573	medium	3610
p37	bars	80	76	4	0.05	medium	3093
p37	bars	14	13	1	0.071428575	medium	2985
p37	bars	46	40	6	0.13043478	medium	3328
p37	bars	1	2	1	1.0	high	3750
p37	bars	83	85	2	0.024096385	medium	4969
p37	bars	59	59	0	0.0	medium	2547
p37	bars	43	38	5	0.11627907	medium	5563
p37	bars	46	41	5	0.10869565	medium	5968
p37	bars	24	26	2	0.083333336	medium	4375
p37	squarepie	75	75	0	0.0	high	7750
p37	squarepie	99	99	0	0.0	high	2265
p37	squarepie	56	56	0	0.0	high	4485
p37	squarepie	39	39	0	0.0	high	3500
p37	squarepie	70	70	0	0.0	high	3359
p37	squarepie	38	38	0	0.0	high	2859
p37	squarepie	69	69	0	0.0	high	5594
p37	squarepie	71	71	0	0.0	high	1594
p37	squarepie	43	43	0	0.0	high	4359
p37	squarepie	70	70	0	0.0	high	1985
p37	squarepie	82	82	0	0.0	high	2640
p37	squarepie	66	66	0	0.0	high	5672
p37	squarepie	23	23	0	0.0	high	3063
p37	squarepie	71	71	0	0.0	high	2671
p37	squarepie	13	13	0	0.0	high	2797
p37	squarepie	16	16	0	0.0	high	2500
p37	squarepie	45	45	0	0.0	high	3188
p37	squarepie	43	43	0	0.0	high	2375
p37	squarepie	46	46	0	0.0	high	2094
p37	squarepie	88	88	0	0.0	high	5578
p37	donut	56	56	0	0.0	medium	4938
p37	donut	45	45	0	0.0	medium	5562
p37	donut	29	27	2	0.06896552	high	4641
p37	donut	3	3	0	0.0	high	6594
p37	donut	57	56	1	0.01754386	medium	7812
p37	donut	31	32	1	0.032258064	medium	3360
p37	donut	63	66	3	0.04761905	medium	5125
p37	donut	96	94	2	0.020833334	medium	4468
p37	donut	64	68	4	0.0625	medium	3829
p37	donut	26	26	0	0.0	high	2750
p37	donut	95	94	1	0.010526316	medium	3343
p37	donut	79	79	0	0.0	medium	4078
p37	donut	36	32	4	0.11111111	medium	5344
p37	donut	40	34	6	0.15	medium	3094
p37	donut	33	30	3	0.09090909	medium	5234
p37	donut	54	53	1	0.018518519	medium	3797
p37	donut	62	59	3	0.048387095	medium	3047
p37	donut	36	37	1	0.027777778	medium	4438
p37	donut	54	54	0	0.0	medium	2250
p37	donut	59	59	0	0.0	medium	3640
p37	piechart	51	51	0	0.0	high	4532
p37	piechart	82	81	1	0.0121951215	medium	6093
p37	piechart	21	21	0	0.0	medium	3204
p37	piechart	11	17	6	0.54545456	medium	5312
p37	piechart	24	23	1	0.041666668	high	3031
p37	piechart	34	32	2	0.05882353	high	7953
p37	piechart	97	96	1	0.010309278	high	4282
p37	piechart	1	2	1	1.0	high	2672
p37	piechart	20	20	0	0.0	medium	6859
p37	piechart	56	57	1	0.017857144	medium	2937
p37	piechart	45	47	2	0.044444446	medium	3032
p37	piechart	51	51	0	0.0	high	1656
p37	piechart	19	19	0	0.0	medium	3609
p37	piechart	83	78	5	0.060240965	medium	3250
p37	piechart	34	36	2	0.05882353	medium	2610
p37	piechart	53	53	0	0.0	high	3812
p37	piechart	77	77	0	0.0	high	2578
p37	piechart	55	58	3	0.054545455	medium	2907
p37	piechart	24	24	0	0.0	high	2265
p37	piechart	29	29	0	0.0	medium	2438
p38	piechart	45	45	0	0.0	high	241556
p38	piechart	54	57	3	0.055555556	high	16978
p38	piechart	26	28	2	0.07692308	high	17521
p38	piechart	49	48	1	0.020408163	high	9643
p38	piechart	53	54	1	0.018867925	high	10419
p38	piechart	69	72	3	0.04347826	medium	40411
p38	piechart	86	85	1	0.011627907	medium	16153
p38	piechart	47	47	0	0.0	high	9371
p38	piechart	83	80	3	0.036144577	high	11526
p38	piechart	72	72	0	0.0	high	9860
p38	piechart	56	56	0	0.0	high	8703
p38	piechart	72	71	1	0.013888889	medium	14455
p38	piechart	66	67	1	0.015151516	medium	10165
p38	piechart	18	20	2	0.11111111	medium	10237
p38	piechart	69	66	3	0.04347826	medium	10367
p38	piechart	17	20	3	0.1764706	medium	7165
p38	piechart	59	58	1	0.016949153	medium	7093
p38	piechart	26	27	1	0.03846154	high	5435
p38	piechart	48	47	1	0.020833334	high	6257
p38	piechart	61	60	1	0.016393442	medium	8515
p38	squarepie	26	28	2	0.07692308	medium	30545
p38	squarepie	35	30	5	0.14285715	medium	6068
p38	squarepie	37	33	4	0.10810811	medium	14297
p38	squarepie	26	20	6	0.23076923	medium	10480
p38	squarepie	19	19	0	0.0	medium	10522
p38	squarepie	49	55	6	0.12244898	medium	8245
p38	squarepie	7	3	4	0.5714286	medium	7810
p38	squarepie	47	47	0	0.0	medium	63643
p38	squarepie	43	35	8	0.18604651	medium	10683
p38	squarepie	69	73	4	0.057971016	medium	6645
p38	squarepie	44	45	1	0.022727273	medium	7090
p38	squarepie	68	78	10	0.14705883	medium	6063
p38	squarepie	62	69	7	0.11290322	medium	7517
p38	squarepie	85	89	4	0.047058824	medium	9195
p38	squarepie	59	45	14	0.23728813	medium	6737
p38	squarepie	78	80	2	0.025641026	high	5813
p38	squarepie	74	75	1	0.013513514	medium	7510
p38	squarepie	77	78	1	0.012987013	medium	2998
p38	squarepie	26	27	1	0.03846154	medium	11582
p38	squarepie	75	87	12	0.16	medium	4708
p38	donut	41	43	2	0.048780486	medium	10550
p38	donut	62	60	2	0.032258064	medium	4265
p38	donut	64	66	2	0.03125	medium	5802
p38	donut	72	72	0	0.0	medium	7145
p38	donut	89	90	1	0.011235955	high	7063
p38	donut	52	52	0	0.0	high	5477
p38	donut	32	28	4	0.125	medium	7158
p38	donut	5	7	2	0.4	high	5878
p38	donut	47	47	0	0.0	high	5830
p38	donut	60	58	2	0.033333335	medium	4857
p38	donut	40	42	2	0.05	medium	5448
p38	donut	55	54	1	0.018181818	medium	4033
p38	donut	66	63	3	0.045454547	high	7827
p38	donut	59	57	2	0.033898305	medium	11539
p38	donut	64	68	4	0.0625	medium	6888
p38	donut	99	98	1	0.01010101	high	6341
p38	donut	61	59	2	0.032786883	medium	5344
p38	donut	43	46	3	0.069767445	medium	7805
p38	donut	9	10	1	0.11111111	medium	4002
p38	donut	47	47	0	0.0	high	4264
p38	bars	29	33	4	0.13793103	medium	5129
p38	bars	58	60	2	0.03448276	medium	6137
p38	bars	73	75	2	0.02739726	medium	4554
p38	bars	34	30	4	0.11764706	medium	4043
p38	bars	13	15	2	0.15384616	medium	5296
p38	bars	70	75	5	0.071428575	medium	6052
p38	bars	53	55	2	0.03773585	medium	5716
p38	bars	36	35	1	0.027777778	medium	4548
p38	bars	12	15	3	0.25	medium	8356
p38	bars	79	80	1	0.012658228	medium	4412
p38	bars	12	18	6	0.5	medium	4450
p38	bars	63	65	2	0.031746034	medium	4212
p38	bars	36	30	6	0.16666667	medium	4966
p38	bars	18	20	2	0.11111111	medium	2923
p38	bars	13	15	2	0.15384616	medium	3925
p38	bars	81	80	1	0.012345679	medium	4561
p38	bars	78	75	3	0.03846154	medium	3035
p38	bars	74	70	4	0.054054055	medium	4393
p38	bars	99	98	1	0.01010101	high	4239
p38	bars	94	93	1	0.010638298	medium	4905
p39	piechart	47	33	14	0.29787233	high	6033
p39	piechart	33	33	0	0.0	high	8329
p39	piechart	75	75	0	0.0	high	3125
p39	piechart	25	25	0	0.0	high	1932
p39	piechart	63	66	3	0.04761905	high	3882
p39	piechart	42	40	2	0.04761905	medium	5542
p39	piechart	31	33	2	0.06451613	high	4423
p39	piechart	22	20	2	0.09090909	medium	4886
p39	piechart	34	33	1	0.029411765	high	2112
p39	piechart	66	66	0	0.0	high	2184
p39	piechart	58	60	2	0.03448276	high	4582
p39	piechart	64	66	2	0.03125	high	3798
p39	piechart	1	2	1	1.0	medium	4302
p39	piechart	23	20	3	0.13043478	medium	4882
p39	piechart	76	80	4	0.05263158	medium	4147
p39	piechart	69	70	1	0.014492754	medium	8890
p39	piechart	63	66	3	0.04761905	high	3605
p39	piechart	5	5	0	0.0	medium	8829
p39	piechart	28	30	2	0.071428575	medium	3346
p39	piechart	39	40	1	0.025641026	medium	3517
p39	donut	41	40	1	0.024390243	medium	6610
p39	donut	33	33	0	0.0	high	2616
p39	donut	57	60	3	0.05263158	medium	6463
p39	donut	49	49	0	0.0	medium	3080
p39	donut	44	45	1	0.022727273	medium	7011
p39	donut	20	20	0	0.0	medium	5310
p39	donut	71	70	1	0.014084507	medium	6303
p39	donut	54	55	1	0.018518519	medium	4515
p39	donut	15	15	0	0.0	medium	4690
p39	donut	49	49	0	0.0	high	2386
p39	donut	80	80	0	0.0	medium	5613
p39	donut	77	77	0	0.0	medium	8387
p39	donut	58	60	2	0.03448276	medium	11631
p39	donut	53	55	2	0.03773585	medium	3587
p39	donut	21	20	1	0.04761905	medium	3171
p39	donut	27	28	1	0.037037037	medium	4969
p39	donut	67	60	7	0.104477614	medium	32492
p39	donut	14	15	1	0.071428575	medium	2762
p39	donut	63	66	3	0.04761905	medium	3281
p39	donut	73	72	1	0.01369863	medium	4467
p39	bars	32	30	2	0.0625	medium	5058
p39	bars	99	98	1	0.01010101	high	4133
p39	bars	74	80	6	0.08108108	medium	3891
p39	bars	88	85	3	0.03409091	medium	3297
p39	bars	1	2	1	1.0	high	2817
p39	bars	22	15	7	0.3181818	medium	3466
p39	bars	44	40	4	0.09090909	high	3827
p39	bars	23	20	3	0.13043478	high	3254
p39	bars	1	2	1	1.0	high	2478
p39	bars	17	15	2	0.11764706	high	2457
p39	bars	19	20	1	0.05263158	medium	2356
p39	bars	4	5	1	0.25	medium	3242
p39	bars	45	45	0	0.0	high	3457
p39	bars	51	50	1	0.019607844	high	2461
p39	bars	28	30	2	0.071428575	high	2315
p39	bars	60	60	0	0.0	medium	3331
p39	bars	65	55	10	0.15384616	medium	2772
p39	bars	46	45	1	0.02173913	medium	2648
p39	bars	84	85	1	0.011904762	medium	2779
p39	bars	72	75	3	0.041666668	medium	3720
p39	squarepie	15	15	0	0.0	high	13697
p39	squarepie	30	30	0	0.0	high	2652
p39	squarepie	59	58	1	0.016949153	high	10354
p39	squarepie	34	34	0	0.0	high	5657
p39	squarepie	79	78	1	0.012658228	high	6092
p39	squarepie	76	76	0	0.0	high	4352
p39	squarepie	22	24	2	0.09090909	high	2899
p39	squarepie	28	28	0	0.0	high	5296
p39	squarepie	53	53	0	0.0	high	13133
p39	squarepie	50	50	0	0.0	high	2784
p39	squarepie	74	74	0	0.0	high	9173
p39	squarepie	64	64	0	0.0	high	2620
p39	squarepie	53	53	0	0.0	high	3030
p39	squarepie	55	55	0	0.0	high	3134
p39	squarepie	51	51	0	0.0	high	1839
p39	squarepie	6	6	0	0.0	high	4651
p39	squarepie	43	33	10	0.23255815	high	3534
p39	squarepie	80	80	0	0.0	high	2883
p39	squarepie	62	62	0	0.0	high	7202
p39	squarepie	54	54	0	0.0	high	4155
p40	donut	51	51	0	0.0	high	45625
p40	donut	77	78	1	0.012987013	high	15063
p40	donut	99	98	1	0.01010101	high	9860
p40	donut	89	90	1	0.011235955	high	30734
p40	donut	58	61	3	0.05172414	high	12063
p40	donut	86	88	2	0.023255814	high	18687
p40	donut	65	65	0	0.0	high	9875
p40	donut	49	49	0	0.0	high	9031
p40	donut	99	98	1	0.01010101	high	8360
p40	donut	26	26	0	0.0	high	16625
p40	donut	8	10	2	0.25	high	17297
p40	donut	27	27	0	0.0	high	4797
p40	donut	10	9	1	0.1	high	14515
p40	donut	99	98	1	0.01010101	high	23016
p40	donut	87	91	4	0.04597701	high	13437
p40	donut	45	48	3	0.06666667	high	10547
p40	donut	86	87	1	0.011627907	high	17687
p40	donut	99	98	1	0.01010101	high	5453
p40	donut	96	95	1	0.010416667	high	5579
p40	donut	56	59	3	0.05357143	high	10546
p40	squarepie	45	45	0	0.0	high	14281
p40	squarepie	53	54	1	0.018867925	high	18094
p40	squarepie	61	62	1	0.016393442	high	6672
p40	squarepie	67	66	1	0.014925373	high	6078
p40	squarepie	53	54	1	0.018867925	high	3531
p40	squarepie	51	52	1	0.019607844	high	3079
p40	squarepie	22	22	0	0.0	high	7593
p40	squarepie	59	58	1	0.016949153	high	5032
p40	squarepie	46	46	0	0.0	high	4312
p40	squarepie	50	50	0	0.0	high	2781
p40	squarepie	99	98	1	0.01010101	high	3782
p40	squarepie	90	90	0	0.0	high	8125
p40	squarepie	67	66	1	0.014925373	high	13984
p40	squarepie	27	26	1	0.037037037	high	10687
p40	squarepie	78	68	10	0.12820514	high	6485
p40	squarepie	36	36	0	0.0	high	4297
p40	squarepie	49	48	1	0.020408163	high	4718
p40	squarepie	75	65	10	0.13333334	high	15188
p40	squarepie	94	94	0	0.0	high	9031
p40	squarepie	51	52	1	0.019607844	high	3328
p40	bars	35	35	0	0.0	medium	20218
p40	bars	7	10	3	0.42857143	medium	4141
p40	bars	53	50	3	0.056603774	high	3813
p40	bars	42	40	2	0.04761905	high	4125
p40	bars	61	60	1	0.016393442	high	5484
p40	bars	84	80	4	0.04761905	high	3921
p40	bars	19	20	1	0.05263158	high	4422
p40	bars	45	40	5	0.11111111	high	2750
p40	bars	39	35	4	0.102564104	high	4735
p40	bars	1	2	1	1.0	high	5375
p40	bars	23	25	2	0.08695652	high	6875
p40	bars	92	90	2	0.02173913	high	4172
p40	bars	42	45	3	0.071428575	high	2875
p40	bars	56	55	1	0.017857144	high	3890
p40	bars	73	65	8	0.10958904	high	8016
p40	bars	60	62	2	0.033333335	high	10515
p40	bars	52	50	2	0.03846154	high	4454
p40	bars	49	48	1	0.020408163	high	2375
p40	bars	55	52	3	0.054545455	high	2062
p40	bars	24	32	8	0.33333334	medium	10688
p40	piechart	22	22	0	0.0	medium	18360
p40	piechart	81	82	1	0.012345679	medium	8125
p40	piechart	52	53	1	0.01923077	medium	4937
p40	piechart	3	8	5	1.6666666	medium	7797
p40	piechart	33	35	2	0.060606062	medium	11016
p40	piechart	69	60	9	0.13043478	medium	8437
p40	piechart	72	68	4	0.055555556	medium	4250
p40	piechart	53	55	2	0.03773585	medium	5235
p40	piechart	85	89	4	0.047058824	medium	10562
p40	piechart	50	50	0	0.0	high	9563
p40	piechart	67	63	4	0.05970149	medium	7859
p40	piechart	84	84	0	0.0	medium	20844
p40	piechart	92	91	1	0.010869565	medium	5047
p40	piechart	47	57	10	0.21276596	medium	4093
p40	piechart	15	17	2	0.13333334	medium	7500
p40	piechart	70	61	9	0.12857144	medium	4782
p40	piechart	39	38	1	0.025641026	medium	7718
p40	piechart	57	58	1	0.01754386	medium	4703
p40	piechart	96	95	1	0.010416667	medium	8375
p40	piechart	41	39	2	0.048780486	medium	7875
p41	bars	26	40	14	0.53846157	high	8938
p41	bars	84	80	4	0.04761905	high	33906
p41	bars	3	4	1	0.33333334	high	50266
p41	bars	53	51	2	0.03773585	high	34718
p41	bars	63	60	3	0.04761905	high	17672
p41	bars	20	18	2	0.1	high	21797
p41	bars	1	1	0	0.0	high	31078
p41	bars	44	42	2	0.045454547	high	24969
p41	bars	20	18	2	0.1	high	17562
p41	bars	54	54	0	0.0	high	21391
p41	bars	99	99	0	0.0	high	11750
p41	bars	41	40	1	0.024390243	high	16562
p41	bars	57	56	1	0.01754386	high	19532
p41	bars	40	40	0	0.0	high	15843
p41	bars	60	58	2	0.033333335	high	15688
p41	bars	13	12	1	0.07692308	high	12609
p41	bars	32	31	1	0.03125	high	14641
p41	bars	8	7	1	0.125	high	17844
p41	bars	32	30	2	0.0625	high	15234
p41	bars	77	75	2	0.025974026	high	14703
p41	piechart	35	33	2	0.057142857	high	5625
p41	piechart	75	72	3	0.04	high	17875
p41	piechart	46	44	2	0.04347826	high	7750
p41	piechart	67	30	37	0.5522388	high	6500
p41	piechart	11	16	5	0.45454547	high	11672
p41	piechart	46	40	6	0.13043478	high	9516
p41	piechart	23	23	0	0.0	high	9453
p41	piechart	25	24	1	0.04	high	4062
p41	piechart	63	60	3	0.04761905	high	9813
p41	piechart	19	20	1	0.05263158	high	20515
p41	piechart	89	80	9	0.101123594	high	3360
p41	piechart	28	28	0	0.0	high	14187
p41	piechart	34	30	4	0.11764706	high	7719
p41	piechart	54	55	1	0.018518519	high	4953
p41	piechart	36	40	4	0.11111111	high	23594
p41	piechart	68	60	8	0.11764706	high	12109
p41	piechart	82	78	4	0.048780486	medium	30141
p41	piechart	78	29	49	0.6282051	high	10046
p41	piechart	75	75	0	0.0	high	4391
p41	piechart	62	65	3	0.048387095	high	10141
p41	squarepie	55	60	5	0.09090909	high	38063
p41	squarepie	94	94	0	0.0	high	53406
p41	squarepie	21	21	0	0.0	high	34812
p41	squarepie	50	50	0	0.0	high	11407
p41	squarepie	17	17	0	0.0	high	7312
p41	squarepie	69	69	0	0.0	high	13484
p41	squarepie	63	63	0	0.0	high	23750
p41	squarepie	1	1	0	0.0	high	4079
p41	squarepie	32	32	0	0.0	high	23000
p41	squarepie	1	1	0	0.0	high	3421
p41	squarepie	15	15	0	0.0	high	4250
p41	squarepie	46	46	0	0.0	high	8828
p41	squarepie	8	8	0	0.0	high	2953
p41	squarepie	70	70	0	0.0	high	10109
p41	squarepie	46	46	0	0.0	high	8282
p41	squarepie	77	77	0	0.0	high	8796
p41	squarepie	51	51	0	0.0	high	2594
p41	squarepie	39	39	0	0.0	high	38500
p41	squarepie	99	99	0	0.0	high	3156
p41	squarepie	40	30	10	0.25	high	24297
p41	donut	25	28	3	0.12	medium	17078
p41	donut	64	68	4	0.0625	medium	17281
p41	donut	76	75	1	0.013157895	medium	11547
p41	donut	53	55	2	0.03773585	medium	4078
p41	donut	33	33	0	0.0	medium	5610
p41	donut	47	48	1	0.021276595	medium	4297
p41	donut	75	25	50	0.6666667	medium	7375
p41	donut	32	30	2	0.0625	medium	5046
p41	donut	63	70	7	0.11111111	medium	9438
p41	donut	49	50	1	0.020408163	high	3250
p41	donut	70	33	37	0.5285714	medium	9266
p41	donut	18	16	2	0.11111111	high	37796
p41	donut	44	45	1	0.022727273	medium	6141
p41	donut	11	10	1	0.09090909	medium	5766
p41	donut	80	80	0	0.0	medium	5484
p41	donut	55	55	0	0.0	medium	3797
p41	donut	84	82	2	0.023809524	medium	7625
p41	donut	28	30	2	0.071428575	medium	7641
p41	donut	49	49	0	0.0	high	7671
p41	donut	59	60	1	0.016949153	high	13094
p42	bars	80	80	0	0.0	high	17344
p42	bars	5	5	0	0.0	medium	7860
p42	bars	27	25	2	0.074074075	high	9046
p42	bars	58	60	2	0.03448276	high	40969
p42	bars	37	35	2	0.054054055	high	12703
p42	bars	78	80	2	0.025641026	high	29938
p42	bars	41	40	1	0.024390243	high	9484
p42	bars	18	16	2	0.11111111	medium	9531
p42	bars	44	40	4	0.09090909	high	6906
p42	bars	96	95	1	0.010416667	high	4532
p42	bars	75	75	0	0.0	high	10500
p42	bars	10	10	0	0.0	high	6062
p42	bars	33	33	0	0.0	high	13500
p42	bars	20	20	0	0.0	medium	9500
p42	bars	43	40	3	0.069767445	high	7266
p42	bars	34	33	1	0.029411765	high	7015
p42	bars	73	75	2	0.02739726	high	25391
p42	bars	22	20	2	0.09090909	high	11406
p42	bars	81	85	4	0.049382716	high	8375
p42	bars	17	15	2	0.11764706	high	4437
p42	squarepie	35	35	0	0.0	high	11078
p42	squarepie	33	34	1	0.030303031	high	13359
p42	squarepie	67	67	0	0.0	high	13484
p42	squarepie	43	43	0	0.0	high	7422
p42	squarepie	45	45	0	0.0	high	5656
p42	squarepie	57	57	0	0.0	high	4906
p42	squarepie	22	22	0	0.0	high	5078
p42	squarepie	94	94	0	0.0	high	8281
p42	squarepie	31	31	0	0.0	high	5329
p42	squarepie	36	36	0	0.0	high	5343
p42	squarepie	10	10	0	0.0	high	3516
p42	squarepie	29	29	0	0.0	high	8312
p42	squarepie	25	25	0	0.0	high	4532
p42	squarepie	81	81	0	0.0	high	3797
p42	squarepie	99	99	0	0.0	high	2750
p42	squarepie	29	29	0	0.0	high	4031
p42	squarepie	53	53	0	0.0	high	3890
p42	squarepie	42	42	0	0.0	high	3922
p42	squarepie	10	10	0	0.0	high	3782
p42	squarepie	54	54	0	0.0	high	8718
p42	piechart	10	10	0	0.0	high	9079
p42	piechart	55	55	0	0.0	high	11921
p42	piechart	44	45	1	0.022727273	high	8157
p42	piechart	35	33	2	0.057142857	high	5609
p42	piechart	60	67	7	0.11666667	high	12063
p42	piechart	19	19	0	0.0	high	26031
p42	piechart	41	38	3	0.07317073	high	15015
p42	piechart	61	60	1	0.016393442	high	15469
p42	piechart	46	45	1	0.02173913	high	3969
p42	piechart	49	48	1	0.020408163	high	4547
p42	piechart	18	17	1	0.055555556	high	17734
p42	piechart	99	98	1	0.01010101	high	7235
p42	piechart	31	28	3	0.09677419	high	15593
p42	piechart	22	22	0	0.0	high	8453
p42	piechart	39	36	3	0.07692308	high	19360
p42	piechart	28	29	1	0.035714287	high	7344
p42	piechart	52	54	2	0.03846154	high	4390
p42	piechart	33	32	1	0.030303031	high	6312
p42	piechart	53	55	2	0.03773585	high	5391
p42	piechart	36	33	3	0.083333336	high	10578
p42	donut	81	83	2	0.024691358	high	21687
p42	donut	22	20	2	0.09090909	high	6125
p42	donut	8	7	1	0.125	high	11953
p42	donut	80	80	0	0.0	high	9766
p42	donut	71	70	1	0.014084507	high	5375
p42	donut	52	55	3	0.057692308	high	5078
p42	donut	1	2	1	1.0	high	3516
p42	donut	99	98	1	0.01010101	high	2937
p42	donut	18	19	1	0.055555556	high	9500
p42	donut	37	33	4	0.10810811	high	6625
p42	donut	39	35	4	0.102564104	high	7375
p42	donut	42	40	2	0.04761905	high	15594
p42	donut	46	45	1	0.02173913	high	4000
p42	donut	35	33	2	0.057142857	high	4656
p42	donut	48	45	3	0.0625	high	2640
p42	donut	73	72	1	0.01369863	high	9157
p42	donut	31	30	1	0.032258064	high	4625
p42	donut	60	63	3	0.05	high	9906
p42	donut	47	46	1	0.021276595	high	5062
p42	donut	28	28	0	0.0	high	5985
p43	bars	29	40	11	0.37931034	medium	29523
p43	bars	24	25	1	0.041666668	medium	23704
p43	bars	38	42	4	0.10526316	low	15192
p43	bars	10	10	0	0.0	medium	11206
p43	bars	57	58	1	0.01754386	medium	11767
p43	bars	13	10	3	0.23076923	low	6489
p43	bars	45	44	1	0.022222223	medium	11497
p43	bars	50	50	0	0.0	medium	3825
p43	bars	1	3	2	2.0	low	10976
p43	bars	81	75	6	0.074074075	medium	6059
p43	bars	52	58	6	0.115384616	low	6489
p43	bars	44	45	1	0.022727273	medium	8833
p43	bars	67	65	2	0.029850746	medium	4096
p43	bars	36	35	1	0.027777778	medium	12778
p43	bars	24	27	3	0.125	low	9604
p43	bars	33	2	31	0.93939394	low	9493
p43	bars	35	45	10	0.2857143	low	7651
p43	bars	72	70	2	0.027777778	medium	5769
p43	bars	61	68	7	0.114754096	medium	6048
p43	bars	41	42	1	0.024390243	medium	14381
p43	donut	5	7	2	0.4	low	12958
p43	donut	79	22	57	0.721519	low	15603
p43	donut	49	46	3	0.06122449	medium	5718
p43	donut	72	75	3	0.041666668	medium	14811
p43	donut	47	40	7	0.14893617	medium	8522
p43	donut	57	55	2	0.03508772	medium	4717
p43	donut	1	2	1	1.0	low	5929
p43	donut	77	75	2	0.025974026	medium	8552
p43	donut	1	3	2	2.0	low	5388
p43	donut	99	98	1	0.01010101	medium	6709
p43	donut	12	20	8	0.6666667	medium	5328
p43	donut	33	33	0	0.0	medium	7992
p43	donut	59	65	6	0.10169491	medium	4947
p43	donut	33	30	3	0.09090909	medium	32066
p43	donut	50	50	0	0.0	high	5037
p43	donut	84	75	9	0.10714286	medium	3635
p43	donut	37	40	3	0.08108108	low	13930
p43	donut	1	5	4	4.0	medium	5088
p43	donut	17	18	1	0.05882353	low	7771
p43	donut	42	40	2	0.04761905	medium	5227
p43	squarepie	47	45	2	0.04255319	low	17666
p43	squarepie	61	60	1	0.016393442	low	5898
p43	squarepie	47	40	7	0.14893617	low	10245
p43	squarepie	38	20	18	0.47368422	low	9484
p43	squarepie	16	15	1	0.0625	low	4847
p43	squarepie	30	22	8	0.26666668	low	4817
p43	squarepie	74	72	2	0.027027028	low	7510
p43	squarepie	39	35	4	0.102564104	low	8913
p43	squarepie	34	22	12	0.3529412	low	6510
p43	squarepie	12	15	3	0.25	low	5237
p43	squarepie	62	63	1	0.016129032	low	4807
p43	squarepie	33	27	6	0.18181819	low	6099
p43	squarepie	41	42	1	0.024390243	low	6038
p43	squarepie	56	55	1	0.017857144	low	7862
p43	squarepie	53	48	5	0.094339624	low	8212
p43	squarepie	28	25	3	0.10714286	low	7030
p43	squarepie	36	33	3	0.083333336	low	4056
p43	squarepie	82	78	4	0.048780486	low	5818
p43	squarepie	38	39	1	0.02631579	low	4997
p43	squarepie	80	85	5	0.0625	low	12308
p43	piechart	20	15	5	0.25	medium	16083
p43	piechart	67	60	7	0.104477614	low	12107
p43	piechart	70	65	5	0.071428575	low	3115
p43	piechart	31	33	2	0.06451613	low	3365
p43	piechart	69	68	1	0.014492754	low	5197
p43	piechart	59	62	3	0.050847456	low	5738
p43	piechart	28	27	1	0.035714287	low	28541
p43	piechart	65	70	5	0.07692308	low	8843
p43	piechart	38	40	2	0.05263158	low	14561
p43	piechart	42	45	3	0.071428575	low	2594
p43	piechart	51	51	0	0.0	medium	4887
p43	piechart	55	55	0	0.0	medium	2804
p43	piechart	75	75	0	0.0	high	4376
p43	piechart	48	46	2	0.041666668	low	7150
p43	piechart	68	66	2	0.029411765	low	5628
p43	piechart	1	11	10	10.0	low	4307
p43	piechart	99	97	2	0.02020202	medium	5447
p43	piechart	46	44	2	0.04347826	low	8052
p43	piechart	50	50	0	0.0	medium	7010
p43	piechart	48	47	1	0.020833334	medium	4847
p44	bars	68	64	4	0.05882353	medium	36036
p44	bars	4	7	3	0.75	high	11372
p44	bars	47	45	2	0.04255319	high	6209
p44	bars	10	12	2	0.2	high	4150
p44	bars	12	15	3	0.25	high	3541
p44	bars	81	72	9	0.11111111	medium	6302
p44	bars	69	70	1	0.014492754	medium	8331
p44	bars	50	50	0	0.0	high	3182
p44	bars	45	46	1	0.022222223	high	6708
p44	bars	37	37	0	0.0	medium	3900
p44	bars	87	85	2	0.022988506	medium	7145
p44	bars	52	53	1	0.01923077	medium	5663
p44	bars	57	60	3	0.05263158	medium	4336
p44	bars	40	40	0	0.0	medium	5273
p44	bars	62	60	2	0.032258064	medium	2309
p44	bars	24	30	6	0.25	medium	3089
p44	bars	1	3	2	2.0	high	4196
p44	bars	47	49	2	0.04255319	high	3775
p44	bars	85	80	5	0.05882353	medium	3932
p44	bars	65	64	1	0.015384615	medium	5226
p44	piechart	94	90	4	0.04255319	medium	6973
p44	piechart	83	80	3	0.036144577	high	9407
p44	piechart	75	75	0	0.0	high	2730
p44	piechart	99	98	1	0.01010101	high	4930
p44	piechart	51	52	1	0.019607844	high	4539
p44	piechart	26	26	0	0.0	high	4696
p44	piechart	80	80	0	0.0	high	4462
p44	piechart	65	62	3	0.046153847	medium	8470
p44	piechart	25	24	1	0.04	medium	3854
p44	piechart	52	53	1	0.01923077	high	4617
p44	piechart	42	40	2	0.04761905	high	3744
p44	piechart	70	69	1	0.014285714	medium	7395
p44	piechart	43	40	3	0.069767445	medium	3478
p44	piechart	49	48	1	0.020408163	high	3464
p44	piechart	13	23	10	0.7692308	medium	9126
p44	piechart	52	54	2	0.03846154	high	4820
p44	piechart	85	83	2	0.023529412	medium	9204
p44	piechart	88	85	3	0.03409091	medium	3385
p44	piechart	65	60	5	0.07692308	medium	5616
p44	piechart	54	55	1	0.018518519	high	2823
p44	donut	67	64	3	0.04477612	medium	13541
p44	donut	39	40	1	0.025641026	medium	5054
p44	donut	54	54	0	0.0	high	4946
p44	donut	34	36	2	0.05882353	high	9812
p44	donut	71	70	1	0.014084507	high	2902
p44	donut	53	58	5	0.094339624	high	3260
p44	donut	99	98	1	0.01010101	high	4181
p44	donut	68	69	1	0.014705882	high	6848
p44	donut	32	30	2	0.0625	medium	2917
p44	donut	73	73	0	0.0	high	6209
p44	donut	25	23	2	0.08	high	4056
p44	donut	53	55	2	0.03773585	high	5413
p44	donut	30	30	0	0.0	high	3682
p44	donut	52	54	2	0.03846154	high	3884
p44	donut	49	48	1	0.020408163	high	3790
p44	donut	1	3	2	2.0	high	2574
p44	donut	31	32	1	0.032258064	medium	3089
p44	donut	12	18	6	0.5	medium	8175
p44	donut	4	8	4	1.0	medium	2964
p44	donut	52	55	3	0.057692308	medium	6723
p44	squarepie	42	40	2	0.04761905	low	6832
p44	squarepie	60	65	5	0.083333336	medium	4524
p44	squarepie	21	25	4	0.1904762	medium	4571
p44	squarepie	32	35	3	0.09375	medium	2325
p44	squarepie	58	48	10	0.1724138	medium	5647
p44	squarepie	69	68	1	0.014492754	medium	7457
p44	squarepie	75	73	2	0.026666667	medium	3260
p44	squarepie	88	90	2	0.022727273	medium	3806
p44	squarepie	51	53	2	0.039215688	medium	3744
p44	squarepie	1	5	4	4.0	medium	2918
p44	squarepie	36	28	8	0.22222222	high	10342
p44	squarepie	16	18	2	0.125	medium	3604
p44	squarepie	1	5	4	4.0	medium	2168
p44	squarepie	75	70	5	0.06666667	medium	4634
p44	squarepie	42	45	3	0.071428575	medium	5116
p44	squarepie	23	20	3	0.13043478	medium	12090
p44	squarepie	38	32	6	0.15789473	medium	3495
p44	squarepie	50	48	2	0.04	medium	3697
p44	squarepie	39	36	3	0.07692308	medium	5663
p44	squarepie	64	62	2	0.03125	medium	3744
p45	squarepie	11	11	0	0.0	high	6601
p45	squarepie	26	26	0	0.0	high	6095
p45	squarepie	20	20	0	0.0	high	2543
p45	squarepie	53	53	0	0.0	high	3176
p45	squarepie	3	3	0	0.0	high	1512
p45	squarepie	71	71	0	0.0	high	3615
p45	squarepie	67	67	0	0.0	high	5495
p45	squarepie	35	35	0	0.0	high	3495
p45	squarepie	51	51	0	0.0	high	2544
p45	squarepie	45	45	0	0.0	high	3960
p45	squarepie	52	52	0	0.0	high	3607
p45	squarepie	88	88	0	0.0	high	2903
p45	squarepie	69	69	0	0.0	high	4247
p45	squarepie	85	85	0	0.0	high	3304
p45	squarepie	6	6	0	0.0	high	2960
p45	squarepie	36	36	0	0.0	high	3399
p45	squarepie	45	45	0	0.0	high	3991
p45	squarepie	14	14	0	0.0	high	3439
p45	squarepie	29	29	0	0.0	high	2376
p45	squarepie	60	60	0	0.0	high	2184
p45	piechart	1	2	1	1.0	medium	4065
p45	piechart	31	35	4	0.12903225	medium	5960
p45	piechart	55	57	2	0.036363635	high	15351
p45	piechart	29	35	6	0.20689656	medium	4232
p45	piechart	10	21	11	1.1	medium	11591
p45	piechart	97	95	2	0.020618556	low	5384
p45	piechart	22	20	2	0.09090909	low	26134
p45	piechart	53	55	2	0.03773585	high	3983
p45	piechart	5	8	3	0.6	medium	3952
p45	piechart	61	62	1	0.016393442	high	20471
p45	piechart	36	35	1	0.027777778	high	11519
p45	piechart	46	45	1	0.02173913	high	2432
p45	piechart	57	60	3	0.05263158	low	3408
p45	piechart	32	35	3	0.09375	medium	6431
p45	piechart	72	70	2	0.027777778	medium	10704
p45	piechart	78	79	1	0.012820513	high	14151
p45	piechart	40	40	0	0.0	medium	3887
p45	piechart	6	10	4	0.6666667	medium	2767
p45	piechart	97	96	1	0.010309278	medium	9159
p45	piechart	23	22	1	0.04347826	high	5887
p45	bars	74	74	0	0.0	high	20536
p45	bars	76	75	1	0.013157895	high	5088
p45	bars	7	8	1	0.14285715	high	17495
p45	bars	84	83	1	0.011904762	high	6031
p45	bars	45	45	0	0.0	high	2143
p45	bars	17	17	0	0.0	medium	5823
p45	bars	37	36	1	0.027027028	high	7256
p45	bars	26	26	0	0.0	high	5623
p45	bars	76	75	1	0.013157895	high	2607
p45	bars	30	30	0	0.0	high	2896
p45	bars	99	99	0	0.0	high	10135
p45	bars	87	86	1	0.011494253	high	4655
p45	bars	4	4	0	0.0	high	3104
p45	bars	32	32	0	0.0	high	3576
p45	bars	64	63	1	0.015625	high	3208
p45	bars	69	68	1	0.014492754	high	8399
p45	bars	55	54	1	0.018181818	high	1944
p45	bars	35	34	1	0.028571429	high	3800
p45	bars	1	1	0	0.0	high	3152
p45	bars	13	14	1	0.07692308	high	2567
p45	donut	52	52	0	0.0	medium	4334
p45	donut	58	5	53	0.9137931	medium	4598
p45	donut	53	53	0	0.0	high	2887
p45	donut	14	17	3	0.21428572	high	3775
p45	donut	16	19	3	0.1875	high	1903
p45	donut	24	23	1	0.041666668	high	3160
p45	donut	50	50	0	0.0	high	4664
p45	donut	44	44	0	0.0	high	14311
p45	donut	87	75	12	0.13793103	high	8879
p45	donut	27	28	1	0.037037037	high	5295
p45	donut	51	51	0	0.0	high	4384
p45	donut	38	37	1	0.02631579	high	11239
p45	donut	62	62	0	0.0	high	13294
p45	donut	16	14	2	0.125	high	3975
p45	donut	55	53	2	0.036363635	high	9503
p45	donut	34	26	8	0.23529412	high	4207
p45	donut	99	98	1	0.01010101	high	2223
p45	donut	24	23	1	0.041666668	high	5048
p45	donut	67	67	0	0.0	high	11487
p45	donut	78	79	1	0.012820513	high	4351
p46	donut	39	33	6	0.15384616	high	10390
p46	donut	41	35	6	0.14634146	high	14188
p46	donut	99	97	2	0.02020202	high	7765
p46	donut	83	85	2	0.024096385	medium	5109
p46	donut	78	80	2	0.025641026	medium	6422
p46	donut	25	25	0	0.0	high	2703
p46	donut	68	67	1	0.014705882	high	2719
p46	donut	33	30	3	0.09090909	high	5188
p46	donut	20	22	2	0.1	medium	10343
p46	donut	80	83	3	0.0375	medium	8563
p46	donut	59	60	1	0.016949153	medium	5125
p46	donut	45	47	2	0.044444446	high	5750
p46	donut	55	52	3	0.054545455	high	3953
p46	donut	69	70	1	0.014492754	medium	7859
p46	donut	72	73	1	0.013888889	medium	4469
p46	donut	29	27	2	0.06896552	high	2500
p46	donut	64	67	3	0.046875	medium	2766
p46	donut	60	65	5	0.083333336	medium	2890
p46	donut	97	95	2	0.020618556	high	2813
p46	donut	26	26	0	0.0	high	2172
p46	bars	1	1	0	0.0	high	2969
p46	bars	51	50	1	0.019607844	high	1593
p46	bars	56	52	4	0.071428575	medium	3016
p46	bars	60	55	5	0.083333336	medium	3781
p46	bars	16	15	1	0.0625	medium	3610
p46	bars	76	75	1	0.013157895	high	2453
p46	bars	91	90	1	0.010989011	high	3000
p46	bars	9	10	1	0.11111111	high	3812
p46	bars	38	40	2	0.05263158	medium	2953
p46	bars	91	90	1	0.010989011	high	2688
p46	bars	40	45	5	0.125	low	4797
p46	bars	21	15	6	0.2857143	medium	5390
p46	bars	34	25	9	0.2647059	high	2047
p46	bars	88	8	80	0.90909094	medium	5969
p46	bars	21	10	11	0.52380955	medium	8156
p46	bars	15	10	5	0.33333334	medium	2985
p46	bars	79	75	4	0.050632913	medium	2390
p46	bars	90	90	0	0.0	high	3516
p46	bars	84	85	1	0.011904762	medium	2437
p46	bars	41	33	8	0.19512194	medium	2610
p46	piechart	25	25	0	0.0	high	2828
p46	piechart	65	67	2	0.03076923	high	2172
p46	piechart	82	80	2	0.024390243	high	3265
p46	piechart	92	90	2	0.02173913	high	2735
p46	piechart	38	33	5	0.13157895	high	2109
p46	piechart	83	82	1	0.012048192	medium	4578
p46	piechart	24	24	0	0.0	high	1985
p46	piechart	74	74	0	0.0	high	3703
p46	piechart	58	60	2	0.03448276	high	6109
p46	piechart	99	99	0	0.0	high	1625
p46	piechart	56	60	4	0.071428575	high	11047
p46	piechart	72	73	1	0.013888889	high	3094
p46	piechart	90	85	5	0.055555556	high	3125
p46	piechart	31	30	1	0.032258064	high	3047
p46	piechart	99	99	0	0.0	high	2375
p46	piechart	41	42	1	0.024390243	medium	6047
p46	piechart	78	78	0	0.0	high	3796
p46	piechart	45	45	0	0.0	medium	5969
p46	piechart	21	20	1	0.04761905	medium	2891
p46	piechart	34	35	1	0.029411765	medium	5907
p46	squarepie	39	39	0	0.0	high	10766
p46	squarepie	91	91	0	0.0	high	4781
p46	squarepie	53	53	0	0.0	high	4953
p46	squarepie	39	39	0	0.0	high	8438
p46	squarepie	25	25	0	0.0	high	1890
p46	squarepie	46	45	1	0.02173913	high	3672
p46	squarepie	1	1	0	0.0	high	1672
p46	squarepie	65	75	10	0.15384616	high	4250
p46	squarepie	43	43	0	0.0	high	15219
p46	squarepie	72	83	11	0.15277778	medium	9985
p46	squarepie	68	78	10	0.14705883	medium	4312
p46	squarepie	53	53	0	0.0	high	4375
p46	squarepie	42	42	0	0.0	high	4125
p46	squarepie	47	47	0	0.0	high	4406
p46	squarepie	1	1	0	0.0	high	1375
p46	squarepie	31	31	0	0.0	high	4594
p46	squarepie	92	92	0	0.0	high	3797
p46	squarepie	94	94	0	0.0	high	2109
p46	squarepie	42	42	0	0.0	high	5797
p46	squarepie	26	26	0	0.0	high	7328
p47	donut	64	66	2	0.03125	high	20843
p47	donut	41	40	1	0.024390243	medium	21782
p47	donut	17	17	0	0.0	medium	14328
p47	donut	64	66	2	0.03125	high	8984
p47	donut	38	33	5	0.13157895	medium	15844
p47	donut	62	66	4	0.06451613	high	7390
p47	donut	52	53	1	0.01923077	medium	6438
p47	donut	70	70	0	0.0	medium	7047
p47	donut	51	51	0	0.0	medium	5219
p47	donut	38	33	5	0.13157895	medium	4859
p47	donut	62	66	4	0.06451613	high	6703
p47	donut	34	30	4	0.11764706	medium	10516
p47	donut	42	41	1	0.023809524	medium	6593
p47	donut	25	25	0	0.0	high	3282
p47	donut	66	66	0	0.0	high	5453
p47	donut	6	8	2	0.33333334	medium	9469
p47	donut	30	30	0	0.0	medium	7485
p47	donut	60	60	0	0.0	medium	5234
p47	donut	30	30	0	0.0	medium	6484
p47	donut	88	85	3	0.03409091	medium	9860
p47	bars	31	25	6	0.19354838	medium	10000
p47	bars	47	45	2	0.04255319	low	4625
p47	bars	52	50	2	0.03846154	high	3609
p47	bars	38	33	5	0.13157895	medium	3594
p47	bars	16	15	1	0.0625	medium	9375
p47	bars	82	85	3	0.036585364	medium	4953
p47	bars	94	93	1	0.010638298	medium	8438
p47	bars	58	56	2	0.03448276	medium	2953
p47	bars	20	16	4	0.2	medium	4328
p47	bars	64	66	2	0.03125	medium	6453
p47	bars	16	16	0	0.0	medium	3703
p47	bars	83	85	2	0.024096385	medium	3375
p47	bars	52	50	2	0.03846154	high	4625
p47	bars	75	75	0	0.0	medium	5578
p47	bars	80	80	0	0.0	medium	3110
p47	bars	43	41	2	0.046511628	medium	2734
p47	bars	70	70	0	0.0	low	9828
p47	bars	17	15	2	0.11764706	medium	4313
p47	bars	13	12	1	0.07692308	medium	5656
p47	bars	18	15	3	0.16666667	medium	2187
p47	squarepie	32	32	0	0.0	high	8094
p47	squarepie	81	81	0	0.0	high	3953
p47	squarepie	73	73	0	0.0	high	3766
p47	squarepie	27	27	0	0.0	high	5594
p47	squarepie	64	64	0	0.0	high	6828
p47	squarepie	36	36	0	0.0	high	3828
p47	squarepie	50	50	0	0.0	high	3328
p47	squarepie	38	38	0	0.0	high	3937
p47	squarepie	36	36	0	0.0	high	3563
p47	squarepie	65	65	0	0.0	high	7734
p47	squarepie	47	47	0	0.0	high	7125
p47	squarepie	69	69	0	0.0	high	5578
p47	squarepie	73	73	0	0.0	high	2703
p47	squarepie	99	99	0	0.0	high	2563
p47	squarepie	48	48	0	0.0	high	3656
p47	squarepie	61	61	0	0.0	high	3344
p47	squarepie	34	34	0	0.0	high	2656
p47	squarepie	70	70	0	0.0	high	2313
p47	squarepie	10	10	0	0.0	high	1750
p47	squarepie	58	58	0	0.0	high	4171
p47	piechart	18	16	2	0.11111111	medium	17703
p47	piechart	1	2	1	1.0	medium	7235
p47	piechart	48	46	2	0.041666668	medium	4265
p47	piechart	86	83	3	0.034883723	medium	3735
p47	piechart	22	21	1	0.045454547	medium	10234
p47	piechart	25	25	0	0.0	medium	4844
p47	piechart	1	2	1	1.0	medium	3047
p47	piechart	54	56	2	0.037037037	medium	2671
p47	piechart	44	43	1	0.022727273	medium	3079
p47	piechart	66	66	0	0.0	medium	3046
p47	piechart	59	60	1	0.016949153	medium	3500
p47	piechart	99	98	1	0.01010101	medium	2438
p47	piechart	13	10	3	0.23076923	medium	16672
p47	piechart	1	2	1	1.0	medium	1765
p47	piechart	36	33	3	0.083333336	medium	4344
p47	piechart	14	16	2	0.14285715	medium	3500
p47	piechart	42	36	6	0.14285715	medium	7141
p47	piechart	83	82	1	0.012048192	medium	8875
p47	piechart	59	60	1	0.016949153	medium	4390
p47	piechart	65	66	1	0.015384615	medium	7157
p48	piechart	51	32	19	0.37254903	high	83941
p48	piechart	55	35	20	0.36363637	high	20890
p48	piechart	36	20	16	0.44444445	high	8142
p48	piechart	16	10	6	0.375	high	6760
p48	piechart	49	28	21	0.42857143	high	9834
p48	piechart	72	72	0	0.0	high	42721
p48	piechart	98	97	1	0.010204081	high	18777
p48	piechart	41	35	6	0.14634146	high	22142
p48	piechart	46	40	6	0.13043478	high	6389
p48	piechart	68	70	2	0.029411765	high	39717
p48	piechart	61	65	4	0.06557377	high	5428
p48	piechart	46	45	1	0.02173913	high	12218
p48	piechart	57	55	2	0.03508772	high	6839
p48	piechart	5	5	0	0.0	high	12799
p48	piechart	71	72	1	0.014084507	high	14010
p48	piechart	3	5	2	0.6666667	high	7541
p48	piechart	56	55	1	0.017857144	high	7300
p48	piechart	52	53	1	0.01923077	high	6670
p48	piechart	41	25	16	0.3902439	high	8272
p48	piechart	99	98	1	0.01010101	high	10014
p48	donut	87	80	7	0.08045977	medium	19157
p48	donut	81	80	1	0.012345679	medium	12378
p48	donut	47	47	0	0.0	medium	14321
p48	donut	40	38	2	0.05	medium	15953
p48	donut	65	60	5	0.07692308	medium	4096
p48	donut	48	48	0	0.0	medium	7150
p48	donut	1	3	2	2.0	medium	9984
p48	donut	19	15	4	0.21052632	medium	12208
p48	donut	55	55	0	0.0	medium	3395
p48	donut	52	52	0	0.0	medium	10064
p48	donut	63	58	5	0.07936508	medium	12819
p48	donut	14	13	1	0.071428575	medium	14340
p48	donut	95	94	1	0.010526316	medium	10055
p48	donut	20	20	0	0.0	medium	10465
p48	donut	55	55	0	0.0	medium	6589
p48	donut	70	71	1	0.014285714	medium	9684
p48	donut	44	45	1	0.022727273	medium	9634
p48	donut	53	52	1	0.018867925	medium	10135
p48	donut	96	96	0	0.0	medium	8402
p48	donut	87	90	3	0.03448276	medium	10585
p48	squarepie	45	45	0	0.0	medium	8932
p48	squarepie	99	95	4	0.04040404	medium	14481
p48	squarepie	50	50	0	0.0	medium	4467
p48	squarepie	37	35	2	0.054054055	medium	16654
p48	squarepie	90	90	0	0.0	medium	18606
p48	squarepie	50	50	0	0.0	medium	5879
p48	squarepie	11	15	4	0.36363637	medium	14961
p48	squarepie	62	70	8	0.12903225	medium	8973
p48	squarepie	48	45	3	0.0625	medium	47559
p48	squarepie	29	20	9	0.31034482	medium	24495
p48	squarepie	22	30	8	0.36363637	medium	10906
p48	squarepie	65	70	5	0.07692308	medium	7821
p48	squarepie	99	95	4	0.04040404	medium	4036
p48	squarepie	25	25	0	0.0	medium	33598
p48	squarepie	21	21	0	0.0	medium	3235
p48	squarepie	9	9	0	0.0	medium	3555
p48	squarepie	20	20	0	0.0	medium	4646
p48	squarepie	42	42	0	0.0	medium	9785
p48	squarepie	60	60	0	0.0	medium	7220
p48	squarepie	35	45	10	0.2857143	medium	28241
p48	bars	47	45	2	0.04255319	medium	11086
p48	bars	44	40	4	0.09090909	medium	3915
p48	bars	33	30	3	0.09090909	medium	12638
p48	bars	62	70	8	0.12903225	medium	7972
p48	bars	55	55	0	0.0	medium	4036
p48	bars	20	25	5	0.25	medium	2653
p48	bars	51	50	1	0.019607844	medium	4817
p48	bars	1	3	2	2.0	medium	8693
p48	bars	99	96	3	0.030303031	medium	9183
p48	bars	1	3	2	2.0	medium	3555
p48	bars	54	55	1	0.018518519	medium	3065
p48	bars	42	45	3	0.071428575	medium	11937
p48	bars	99	96	3	0.030303031	medium	4146
p48	bars	44	46	2	0.045454547	medium	6339
p48	bars	17	25	8	0.47058824	medium	2473
p48	bars	80	75	5	0.0625	medium	2584
p48	bars	29	25	4	0.13793103	medium	5879
p48	bars	85	75	10	0.11764706	medium	3044
p48	bars	25	30	5	0.2	medium	11146
p48	bars	22	25	3	0.13636364	medium	4997
